transcription	normalisation
༠	0
༡	1
༢	2
༣	3
༤	4
༥	5
༦	6
༧	7
༨	8
༩	9
<	(
>	)
(	(
)	)
「	'
」	'
『	\"
』	\"
﹁	'
﹂	'
[	[
]	]
【	[
】	]
གྶ་	གས་
བྶ་	བས་
ངྶ་	ངས་
མྶ་	མས་
ཌ།	གས།
ཊ།	གས།
ཀའི	ཀ་བའི
ཀསྱེགཀྲྯེར	ཀ་གསེག་ཀ་འདྲ་ཟེར
ཀྭརྩ	ཀ་རྩྭ
ཀྐིང༌	ཀི་ཀང༌
ཀིི་སོོ	ཀི་ཀི་སྭོ་སྭོ
ཀིི་སྭོོ	ཀི་ཀི་སྭོ་སྭོ
ཀུཾ༹ལ༹	ཀུ་མུད་ཚལ
ཀུཾད	ཀུ་མུད
ཀུ༹ན	ཀུ་ཙན་དན
ཀུནྱབ	ཀུན་ཁྱབ
ཀུནིཊ	ཀུན་གཟིགས
ཀིུགས	ཀུན་གཟིགས
ཀིུཊ	ཀུན་གཟིགས
ཀུནལ	ཀུན་གསལ
ཀུནི	ཀུན་གྱི
ཀུནྱིས	ཀུན་གྱིས
ཀུནྲུབ	ཀུན་གྲུབ
ཀུནགྲེ	ཀུན་འགྲེ
ཀུནྲོལ	ཀུན་གྲོལ
ཀུནུ	ཀུན་ཏུ
ཀུནུངོ༌	ཀུན་ཏུ་བཟང་པོ
ཀོུནུང	ཀུན་ཏུ་བཟང་པོ
ཀུནྟུཾ༹	ཀུན་ཏུ་བཟང
ཀུནྟུང༌	ཀུན་ཏུང༌
ཀིུས	ཀུན་དཀྲིས
ཀུནའ	ཀུན་དགའ
ཀུནས་འབབ	ཀུན་ནས་འབབ
ཀུནས	ཀུན་ནས
ཀུནྶ	ཀུན་ནས
ཀུནོ	ཀུན་པོ
ཀུནྕེད	ཀུན་བཅད་དེ
ཀུནང༌	ཀུན་བཟང༌
ཀུནཟང༌	ཀུན་བཟང༌
ཀུཾ༹ན	ཀུན་བཟང༌
ཀུནྯང	ཀུན་བཟང
ཀོུནང༌	ཀུན་བཟང་པོ
ཀུན༹ང	ཀུན་བཟང
ངྐུན	ཀུན་བཟང
ཀུནྡུང	ཀུན་བརྡུངས
ཀུནྱཻནོ	ཀུན་མཁྱེན་ཆེན་པོ
ཀུནྱེན	ཀུན་མཁྱེན
ཀེུན	ཀུན་མཁྱེན
ཀུནོམས	ཀུན་འཇོམས
ཀོུ༹བ	ཀུན་རྫོབ
ཀོུབ	ཀུན་རྫོབ
ཀོུབ༹	ཀུན་རྫོབ
ཀེུས	ཀུན་ཤེས
ཀུནྱོད	ཀུན་སྤྱོད
ཀུནློགྱང	ཀུན་ལོག་ཀྱང
ཀུན་ཏུ	ཀུནུ
ཀུཾ་ཀུཾ	ཀུམ་ཀུམ
ཀཻམ	ཀེམ་ཀེམ
ཀེ༹ང	ཀེའུ་ཚང
ཀྷོཾ་	ཀོ་ལྷམ་
ཀཽང	ཀོང་ཀོང
ཀྱགོ	ཀྱག་ཀྱོག
ཀྱངང	ཀྱང་ཡང
ཀྱརོ	ཀྱར་ཀྱོར
ཀྱལོ	ཀྱལ་ཀྱོལ
ཀྱིཞི	ཀྱི་གཞི
ཀྱིལྟེ་	ཀྱི་ལྟེ་
ཀྱིསཟོསླག	ཀྱིས་བཟོས་སླག
ཀྱིནློདིགྯང	ཀྱིན་སློད་ཅིག་བཟང
ཀྱུྃ	ཀྱུ་མ
ཀྱཻ	ཀྱེ་ཀྱེ
ཀླཽ	ཀླ་ཀློ
ཀློ	ཀླ་ཀློ
ཀླེུན	ཀླུ་གཉེན
ཀླེུནད	ཀླུ་ཆེན་བརྒྱད
ཀླེུབས	ཀླུ་ཐེབས
ཀླུད	ཀླུ་བདུད
ཀློུག	ཀླུ་ཟློག
ཀློག	ཀླུ་ཟློག
ཀླུ་སྒྲུབྱི	ཀླུ་སྒྲུབ་ཀྱི
ཀླུ་སྒྲུབྱིས༹དའི	ཀླུ་སྒྲུབ་ཀྱིས་མཛད་པའི
ཀླུ་སྒྲུབྱིས	ཀླུ་སྒྲུབ་ཀྱིས
ཀླུའིབོང	ཀླུའི་དབང་བོ
ཁྒངྃ་	ཁ་གང་མ་
ཁསྱབ	ཁ་གསབ
ཁོདག	ཁ་དོག
ཁྡོག	ཁ་དོག
ཁྡྲང	ཁ་དྲང
ཁྲངས	ཁ་དྲངས
ཁ་འཆཾ་གྲོིག	ཁ་འཆམ་གྲོས་འགྲིག
ཁྮེང	ཁ་ཞེང
ཁླགྲོང	ཁ་ལག་སྲོ་དང
ཁླགྲོསིག	ཁ་ལག་སྲོས་ཤིག
ཁྶོ	ཁ་སོ
ཁྶོས	ཁ་སོས
ཁགི	ཁག་གི
ཁཾཉྱེར	ཁང་གཉེར
ཁངའི་	ཁང་བའི་
ཁམུ	ཁམ་ཁུམ
ཁཾ	ཁམ
ཁཾསི	ཁམས་ཀྱི
ཁཾསུཾ་སེཾན	ཁམས་གསུམ་སེམས་ཅན
ཁམསུཾ	ཁམས་གསུམ
ཁམསུམ	ཁམས་གསུམ་
ཁཾསུཾ	ཁམས་གསུམ
ཁམུཾ	ཁམས་གསུམ
ཁམསེང༌	ཁམས་གསེང༌
ཁམསྣ	ཁམས་ན
ཁཾ༹ན	ཁམས་ཚན
ཁཾསྱུངནྱསྯེར	ཁམས་འབྱུང་གནས་ཟེར
ཁམསུ	ཁམས་སུ
ཁཾསུ	ཁམས་སུ
ཁཾས	ཁམས
ཁརེ	ཁར་ཁེར
ཁསླེན	ཁས་ལེན
ཁེུ	ཁུ་ལེ
ཁུགཉིད	ཁུག་གཉིད
ཁུརརྱེད	ཁུར་བྱེད
ཁོུ༹ས	ཁུར་ཚོས
ཁོུས༹	ཁུར་ཚོས
ཁེུན	ཁུར་ལེན
ཁེོལ	ཁེ་ཁོལ
ཁྱེུངས	ཁེངས་བསྐྱུངས
ཁེབསྟེ	ཁེབས་ཏེ
ཁེརེ	ཁེར་རེ
ཁཽ	ཁོ་བོ
ཁྦོ་	ཁོ་བོ་
ཁོགྲྟེན	ཁོག་རྟེན
ཁོགྶྟོང	ཁོག་སྟོང
ཁོངོྃ	ཁོང་སེང་མ
ཁོ༹ནི	ཁོན་འཛིན
ཁོཾ	ཁོམ
ཁོརུག	ཁོར་ཡུག
ཁོལོ	ཁོལ་པོ
ཁོལུ	ཁོལ་བུ
ཁོལོཾ	ཁོལ་མོ
ཁོལུད	ཁོལ་ལུད
ཁོགསུརྣོདེ	ཁོར་གསུར་སྣོད་དེ
ཁོརྻུག	ཁོར་ཡུག
ཁྱདརཾང	ཁྱད་པར་མང
ཁྱདར	ཁྱད་པར
ཁྱབདལ	ཁྱབ་གདལ
ཁྱབར	ཁྱབ་པར
ཁྱབདག	ཁྱབ་བདག
ཁྱབདགིསུང༌	ཁྱབ་བདག་གིས་གསུང༌
ཁྱབདགིསུངསོ	ཁྱབ་བདག་གིས་གསུངས་སོ
ཁྱབརྡལ	ཁྱབ་བརྡལ
ཁྱབྱེད	ཁྱབ་བྱེད
ཁྱིཾ་བདགིས	ཁྱིམ་བདག་གིས
ཁྱིམཚེས	ཁྱིམ་མཚེས
ཁྱིཾ	ཁྱིམ
ཁྱིལི	ཁྱིལ་ཁྱིལ
ཁྱོུག	ཁྱུ་མཆོག
ཁྱུགོན	ཁྱུ་མཆོག་ཅན
ཁྱུགོ༹ན	ཁྱུ་མཆོག་མཚན
ཁྱེུངན	ཁྱུང་ཆེན
ཁྱེུངན	ཁྱུང་ཆེན
ཁྱེདག	ཁྱེད་ཅག
ཁྱེདང༌	ཁྱེད་རང༌
ཁྱོ་ཤུག	ཁྱོ་དང་ཆུང་མ
ཁྱུགོ	ཁྱོ་ཤུག
ཁྱོདང༌	ཁྱོད་རང༌
ཁྱོནུངསོྃ་	ཁྱོན་མཚུགས་པཱི་
ཁྲོ་	ཁྲ་བོ་
ཁྲོགྱྃརྩེའང	ཁྲ་བོ་གྲུམ་རྩེའང
ཁྲགོ	ཁྲག་ཁྲོག
ཁྲགིས	ཁྲག་གིས
ཁྲགུང༌	ཁྲག་འཐུང༌
ཁྲུཾག	ཁྲག་འཐུང༌
ཁྲུགང	ཁྲག་འཐུང
ཁྲབྕན	ཁྲབ་ཅན
ཁྲྃ	ཁྲམ
ཁྲོཾག	ཁྲམ་ཐོག
ཁྲོམག	ཁྲམ་ཐོག
ཁྲི༢	ཁྲི་གཉིས
ཁྲིནེ	ཁྲི་ཆེན
ཁྲིཙན	ཁྲི་བཙན
ཁྲིཞེར	ཁྲི་བཞེར
ཁྲིཟང	ཁྲི་བཟང
ཁྲིངོ༌	ཁྲི་སྲོང༌
ཁྲྲིག	ཁྲིག་ཁྲིག
ཁྲིདང	ཁྲིད་དང
ཁྲོིམད	ཁྲིམ་སྡོད
ཁྲིཾསྴིིང	ཁྲིམས་ཤིང
ཁྲིཾསྲོལྔ	ཁྲིམས་སྲོལ་སྔ
ཁྲིཾས	ཁྲིམས
འཁྲོུད	ཁྲུག་ཅོད
ཁྲྲུང	ཁྲུང་ཁྲུང
ཁྲེུད	ཁྲུན་མེད
ཁྲིུང༌	ཁྲུན་རིང༌
ཁྲུདོ	ཁྲུན་སྟོད
ཁྲུམདོ	ཁྲུམ་སྟོད
ཁྲོུད	ཁྲུམ་སྟོད
ཁྲུམད	ཁྲུམ་སྨད
ཁྲུཾད	ཁྲུམ་སྨད
ཁྲུཾདོ	ཁྲུམས་སྟོད
ཁྲུམསྟོད	ཁྲུམས་སྟོད
ཁྲུམསྨད	ཁྲུམས་སྨད
ཁྲུཾན	ཁྲུས་མཁན
ཁྲེལེད	ཁྲེལ་མེད
ཁྲེལེདཾ	ཁྲེལ་མེད
ཁྲེལོད	ཁྲེལ་ཡོད
ཁྲོརེ	ཁྲོ་གཉེར
ཁྲོནེ	ཁྲོ་ཆེན
ཁྲོེན	ཁྲོ་ཆེན
ཁྲོེར	ཁྲོ་ཉེར
ཁྲཽ་ཁྲཽ	ཁྲོ་བོ་ཁྲོ་མོ
ཁྲཽ་ཆེནོ	ཁྲོ་བོ་ཆེན་པོ
ཁྲཽ	ཁྲོ་བོ
ཁྲོའོཨི	ཁྲོ་བོའི
མྲཽ	ཁྲོ་མོ
ཁྲོལ	ཁྲོ་རྒྱལ
ཁྲོཾནེ	ཁྲོམ་ཆེན
ཁྲོཾ	ཁྲོམ
ཁྲོལེ	ཁྲོལ་ལེ
གླ་	ག་ཟླ
གྱུ	ག་རྒྱུ
གངུ	གང་བུ
གང༹ག	གང་ཟག
གངག	གང་ཟག
གངཟག	གང་ཟག
གངཁྱོལ	གང་འཁྱོལ
གངྱངྲུང	གང་ཡང་རུང
གངླདྕེ	གང་སླད་ཅེ
གཾ	གང
ཅྱག	གཅག
ཅྱཌ་	གཅགས་
ཅྱེང	གཅང་ངེ
ཅྱོང	གཅང་བོ
ཅྱང	གཅང
གངསྦལ	གངས་སྦལ
གཅནྯ	གཅན་གཟན
གཅྯན	གཅན་གཟན
གཅྯན	གཅན་གཟན
ཅྱནཚ	གཅན་ཚ
ཅྱནཕྲང	གཅན་འཕྲང
གཅནྱ྄ང་	གཅན་སྤྱང་
ཅྱྃསྱག	གཅམ་གསག
ཅྱལུ	གཅམ་དུ
ཅྱྃ	གཅམ
ཅྱར	གཅར
གཅིགཉིསུྃ	གཅིག་གཉིས་གསུམ
གཅིགནས	གཅིག་གནས
གཅིགི	གཅིག་གི
󲀇	གཅིག་གི
གཅིགིས	གཅིག་གིས
󲀇ས	གཅིག་གིས
གཅིགསོ	གཅིག་གསོ
གཅིགསོད	གཅིག་གསོད
གཅིགིས	གཅིག་གིས
གཅིགོཉིསྖོད	གཅིག་གོ་གཉིས་ཆོད
གཅིགྱུར	གཅིག་གྱུར
གཅིགྲོཌ་	གཅིག་གྲོགས
གཅྖོིོགོ་	གཅིག་ཆོག་གོ་
གཅིགིད	གཅིག་ཉིད
༡ཏུ	གཅིག་ཏུ
གཅིགུ	གཅིག་ཏུ
གཅིགྟུ	གཅིག་ཏུ
༡ན་རེ	གཅིག་ན་རེ
གཅིགས་ཅུཾར	གཅིག་ནས་བཅུ་གསུམ་བར
གཅིགུྃཚུངསཞིན	གཅིག་མཚུངས་བཞིན
གཅིགྃནི	གཅིག་མིན
གཅིཚིག	གཅིག་ཚིག
གཅིགཇཌ་	གཅིག་འཇགས་
གཅིགྴེས	གཅིག་ཤེས
གཅིགྡུད	གཅིག་སྡུད
གཅིགྡོྃ་	གཅིག་སྡོམ་
ཅྱིནགཌ་	གཅིན་འགགས་
ཅྱིན	གཅིན་ལམ
ཅྱིནྶྙི	གཅིན་སྙི
ཅྱིནྟུག	གཅིན་སྟུག
ཅྱིནྶྲི	གཅིན་སྲི
གཅུལ	གཅུ་གལ
གཅོུ་	གཅུ་བོ
གཅུཚེྃ་	གཅུ་ཚེམ་
གཅུཌ་	གཅུགས་
གཅུཌྃཁན	གཅུགས་མཁན
གཅུཾདནྻོདོ	གཅུང་དོན་ཡོད
གཅོུང་	གཅུང་བོ་
གཅོུྃང	གཅུང་མོ
གཅེུང	གཅེན་གཅུང
གཅྱེྃ་པོ	གཅེན་པོ
ཅྱེནོ	གཅེན་པོ
ཅྱེནོྃ	གཅེན་མོ
ཅེརུྃ་	གཅེར་བུ་མ་
ཅྱེརུའི	གཅེར་བུའི
ཅྱེརོྃ་	གཅེར་མོ་
ཅྱེར་འཛིན	གཅེར་འཛིན
ཅྱེར	གཅེར
ཅྱེསོ་	གཅེས་པོ་
ཅྱེསྲུགྃ་	གཅེས་ཕྲུག་མ་
ཅྱེསྡུས	གཅེས་བསྡུས
གཅེསྡུས	གཅེས་བསྡུས
ཅྱེསིངྃ་	གཅེས་མིང་
ཅྱེསཛིན	གཅེས་འཛིན
ཅྱེསྐྱོང	གཅེས་སྐྱོང
ཅྱེསྲ྄ས	གཅེས་སྤྲས
གཅེསྤྲས	གཅེས་སྤྲས
ཅྱེསྲུང	གཅེས་སྲུང
གཅེསྲུང༌	གཅེས་སྲུང༌
ཅྱོགོས	གཅོག་དགོས
ཅྱོགཁན	གཅོག་མཁན
ཅྱོགརྩིས	གཅོག་རྩིས
ཅྱོང་	གཅོང་
ཅྱོངེ་	གཅོང་ངེ་
ཅྱེངྖེན	གཅོང་ཆེན
ཅྱོངྼོང	གཅོང་རོང
ཅྱོང	གཅོང
ཅྱོདྱི་	གཅོད་ཀྱི་
ཅྱེདརེད	གཅོད་པར་བྱེད
ཅྱོེདེ་	གཅོད་བྱེད་དེ་
ཅྱོདྃཚསྃ	གཅོད་མཚམས
ཅྱོད	གཅོད
ཅྱོྃ	གཅོམ
ཅྱོརྕིག	གཅོར་ཅིག
ཉྱཌ་	གཉགས་
ཉྱནསྱོད	གཉན་གསོད
ཉྱྖེན	གཉན་ཆེན
ཉྱནྠུབ	གཉན་ཐུབ
ཉྱནདཁྱོྃ་	གཉན་ནད་འཁྱམ་པོ
ཉྱནའིནྱེད	གཉན་པའི་གཉད་དེ
ཉྱོན	གཉན་པོ
ཉྱནོའི	གཉན་པོའི
ཉྱནོར	གཉན་པོར
ཉྱནྲན	གཉན་ཕྲན
ཉྱནྦུ	གཉན་བུ
གཉནཚད	གཉན་ཚད
ཉྱནྦུར	གཉན་འབུར
གཉནབྲསོ	གཉན་འབྲས་སོ
ཉྱནྲིན	གཉན་སྲིན
ཉྱན	གཉན,
ཉྱན	གཉན
གཉཾ	གཉམ
ཉྱའནྱོན	གཉའ་གནོན
ཉྱའྕག	གཉའ་བཅག
ཉྱའརཏེཌ་	གཉའ་བར་བཏེགས་
ཉྱའྱེད	གཉའ་བྱེད
ཉྱའིཚིཌ་	གཉའ་ཚིགས་
ཉྱའྕིབས	གཉའ་ལྕིབས
ཉྱའྟག	གཉའ་ལྟག
ཉྱའ	གཉའ
ཉྱིདགཉིདྖེ	གཉིད་ཆག་གཉིད
ཉྱིདཀྲོགིནདུ	གཉིད་དཀྲོག་གིན་འདུག
ཉྱིདང་	གཉིད་དང་
ཉྱིདུསྱི	གཉིད་དུས་ཀྱི
ཉྱིདཐིབ	གཉིད་འཐིབ
ཉྱིདློགཉིད	གཉིད་ལོག་གཉིད
གཉིདྶངས	གཉིད་སངས
ཉྱིད	གཉིད
ཉྱིལ	གཉིལ
༢+ཨིས	གཉིས་ཀྱི
༢ཀྱི	གཉིས་ཀྱི
གཉིཀྱི	གཉིས་ཀྱི
ཉིསྱི	གཉིས་ཀྱི
ཉྱིསྱིསྡོག	གཉིས་ཀྱིས་ལྡོག
གཉཱིསྤྱོད	གཉིས་གཉིས་སྤྱོད
གཉིསུཾ	གཉིས་གསུམ
གཉིསྟེ	གཉིས་ཏེ
གཉིེསད	གཉིས་ཏེ
ཉིཏེ	གཉིས་ཏེ
གཉིསའི	གཉིས་པའི
ཉྱིསཉྃ	གཉིས་མཉམ
གཉིསྃནི	གཉིས་མིན
༢ད	གཉིས་མེད
༢ེད	གཉིས་མེད
གཉིདེ	གཉིས་མེད
གཉིེསད	གཉིས་མེད
གཉིསྃདེསུང་	གཉིས་མེད་གསུང་
གཉི༹ནི	གཉིས་འཛིན
གཉིསི༹ན	གཉིས་འཛིན
གཉིསཛིནཁྲི	གཉིས་འཛིན་འཁྲི
གཉིསུྃདེར	གཉིས་སུ་མེད་པར
ཉྱིསུྃདེ	གཉིས་སུ་མེད
གཉིསེུད	གཉིས་སུ་མེད
༢སུ	གཉིས་སུ
གཉིསུ	གཉིས་སུ
གཉིསོ	གཉིས་སོ
གཉིསྐྱེས	གཉིས་སྐྱེས
ཉྱིསྐྱེས	གཉིས་སྐྱེས
ཉྱིསྟོང་	གཉིས་སྟོང་
ཉྱིསྣང	གཉིས་སྣང
གཉུགྃའི	གཉུག་མའི
གཉུགྃར	གཉུག་མར
གཉུལྟེརྩ	གཉུལ་ཏེ་རྩྭ
ཉྱེ	གཉེ
ཉྱེནཤྱིན	གཉེན་གཤིན
གཉཻན	གཉེན་ཆེན
གཉེནོ	གཉེན་པོ
ཉྱེནོ	གཉེན་པོ
ཉྱེནོའི་	གཉེན་པོའི་
ཉྱེནྲེལ	གཉེན་འབྲེལ
ཉྱེན	གཉེན
ཉྱེརྐ་	གཉེར་ཀ
ཉྱེརྑ་	གཉེར་ཁ་
ཉྱེརདྃས	གཉེར་གདམས
ཉེརུ	གཉེར་དུ
ཉྱེརྃའི	གཉེར་མའི
ཉྱེརཚང་	གཉེར་ཚང་
ཉྱེརཛིན	གཉེར་འཛིན
ཉྱེར	གཉེར
ཉྱེལ	གཉེལ
ཉྱོགྃ	གཉོག་གམ
ཉྱོཌིག	གཉོགས་ཤིག
ཉྱོངྖུ་	གཉོང་ཆུང་
ཉྱེདྐ	གཉོད་ཀ
ཉྱེདྑ	གཉོད་ཁ
ནྱོད	གཉོད
ཉྱོྃངྖུ་	གཉོམ་ཆུང་
ཉྱོས	གཉོས
ཏྱདར	གཏད་པར
གཏདོ	གཏད་སོ
ཏྱད	གཏད
ཏྱནྱི་	གཏན་གྱི་
ཏྱན	གཏན
ཏྱཾཔེར	གཏམ་དཔེར
ཏྱམོ	གཏམ་མོ
ཏྱནཚིཌ་	གཏམ་ཚོགས་
ཏྱྃ	གཏམ
གཏཾ	གཏམ
གཏའཾ	གཏའ་མ
གཏིུག	གཏི་མུག
གཏིུཾག	གཏི་མུག
གཏིུ༹ཊ	གཏིང་ཚུགས
ཏྱིང	གཏིང
གཏིབསའི	གཏིབས་པའི
གཏུནུ	གཏུན་བུ
གཏིུང༌	གཏུན་ཤིང༌
་གཏུནིང	གཏུན་ཤིང
གཏུམོ	གཏུམ་པོ
གཏོུཾ	གཏུམ་པོ
གཏུམོ	གཏུམ་མོ
གཏིུ༹ཾག	གཏུམ་ཚིག
གཏོ༹ད	གཏེར་མཛོད
ཏྱེར	གཏེར
ཏྱོང	གཏོང
ཏྱོདཛོདང	གཏོད་མཛོད་དང
གཏོརཾ	གཏོར་མ
ཏྱོཾར	གཏོར་མ
ཏྱོར་མ	གཏོར་མ
གཏོརོ	གཏོར་རོ
ཏྱོར	གཏོར
ཏྱོལྃདེ་	གཏོལ་མེད་
གདའི	གད་པའི
གདཌསྲིབ	གདགས་སྲིབ
གདབུ	གདབ་བུ
གདབྱ	གདབ་བྱ
གདཾག	གདམ་ངག
གདམག	གདམ་ངག
གདཾག	གདམས་ངག
གདྃསཔ	གདམས་པ
གདཾས	གདམས
གདུ༹བ	གདུག་རྩུབ
གདུཊར	གདུགས་དཀར
གདོུ༹བ	གདུང་འཚོབ
གདིུ༹ན	གདུང་འཛིན
གདིུན	གདུང་འཛིན
གདུང་ངྱུད	གདུང་རྒྱུད
གདུང་ངྱུད	གདུང་རྒྱུད
གདེུན	གདུང་རྟེན
གདུབུ	གདུབ་བུ
གདུལྱ	གདུལ་བྱ
གདུལྱ་	གདུལ་བྱ་
གདོངན	གདོང་ངན
གདོངུ	གདོང་དུ
གདྲོུག	གདོང་དྲུག
གནྡྷོ་ལ	གན་དྷོ་ལ
གནོ༹༹ད	གན་མཛོད
གནྱ	གན་རྒྱ
གནདོན	གནད་དོན
ནྱད	གནད
གནམཚོ	གནམ་མཚོ
གནཾཅཊ	གནམ་ལྕགས
གནྕཾགས	གནམ་ལྕགས
གནྱོཾར	གནམ་སྦྱོར
གནཾ	གནམ
སྣཾ	གནམ
གནསྱི	གནས་ཀྱིས
གནྱིས	གནས་ཀྱིས
ནསྱི	གནས་ཀྱིས
ནྱསྱི	གནས་ཀྱིས
གནསན	གནས་ཅན
གནསེན	གནས་ཆེན
ནྱསྟེ	གནས་ཏེ
ནྱསྲིསུཾ	གནས་རིས་གསུམ
ནྱསརིས	གནས་རིས
གནསེན	གནས་རྟེན
གནསླུཊ	གནས་ལུགས
གནླུགས	གནས་ལུགས
གནླུཊ	གནས་ལུགས
གནསུ	གནས་སུ
ནྱསུ	གནས་སུ
ནྱསུྃ	གནས་སུམ
ནྱསོརྖུད	གནས་སོར་ཆུད
གནསྐབས	གནས་སྐབས
གནསྲུངོ༌	གནས་སྲུང་པོ
ནས	གནས
ཉྱེནགྲིགཉེནྒྲིགཉ	གནེན་འགྲིག་གཉེན་སྒྲིག་གཉེན
གནྱོེད	གནོད་བྱེད
གནོདེ༹ས	གནོད་མཛེས
གནྱོེད	གནོད་མེད
གནྱོདིནགོ	གནོད་སྦྱིན་བདག་པོ
གནྱོིདནགོ	གནོད་སྦྱིན་བདག་པོ
གནོདྱིན	གནོད་སྦྱིན
གནོིདན	གནོད་སྦྱིན
གནྱོདིན	གནོད་སྦྱིན
གནྱོིདན	གནོད་སྦྱིན
གནྱོིན	གནོད་སྦྱིན
ནྱོདིན	གནོད་སྦྱིན
གབསུ	གབས་སུ
གཾ	གམ
གཙངོ་	གཙང་བོ་
ཙྱང	གཙང
རྩང	གཙང
གཙིགསུ་འཛིན་པ	གཙིགས་སུ་འཛིན་པ
གཙུགི	གཙུག་གི
རྩུགི	གཙུག་གི
རྩུགོ	གཙུག་གོ
གཙུགོར	གཙུག་གཏོར
གཙོུརན	གཙུག་ཏོར་ཅན
གཙོུགར	གཙུག་ཏོར
གཙོུར	གཙུག་ཏོར
གཙུགད	གཙུག་པུད
ཙུགད	གཙུག་པུད
རྩུགད	གཙུག་པུད
གཙླུག	གཙུག་ལག
གཙླུགང༌	གཙུག་ལག་ཁང༌
གཙུག་ལགསུཾ	གཙུག་ལག་གསུམ
གཙུགག	གཙུག་ལག
གཙཽ	གཙོ་བོ
གཙཽར	གཙོ་བོར
གཙཽར	གཙོ་འཁོར
གཙོརོ	གཙོ་འཁོར
གཞགསོ	གཞགས་གཞོགས
གཞྲུཾ	གཞང་འབྲུམ
གཞནྱི	གཞན་གྱི
གཞནྱིསོས	གཞན་གྱིས་གསོས
གཞནྱིས	གཞན་གྱིས
ཞྱངང	གཞང་དང
གཞནུ	གཞན་དུ
གཞནང༌	གཞན་ཡང༌
ཞནང	གཞན་ཡང
གན	གཞན
གཞལེཾདང༌	གཞལ་མེད་ཁང༌
གཞལེཾདན	གཞལ་མེད་ཅན
གཞལེཾད	གཞལ་མེད
ཞལྃདྑེང་	གཞལ་མེད་ཁང་
གཞྱསང༌	གཞལ་ཡས་ཁང༌
ཞྱསང༌	གཞལ་ཡས་ཁང༌
གཞཾས	གཞལ་ཡས
གཞྱས	གཞལ་ཡས
ཞྱས	གཞལ་ཡས
ཞྱསཾ	གཞལ་ཡས
གཞལྒང	གཞལ་སྒང
གཞིསུཾ	གཞི་གསུམ
གཞྲིུབ	གཞི་གྲུབ
ཞྱི་	གཞི་
ཞྱིགལྖེན	གཞིག་གལ་ཆེན
ཞྱིཌ་	གཞིགས་
གཞོུག	གཞུ་ཐོག
གཞོུམ	གཞུ་འདོམ
གཞོུཾ	གཞུ་འདོམ
གཞོུམས	གཞུ་འདོམས
གཞིུ༹ན	གཞུ་འཛིན
གཞུ་ལསྐྱེས	གཞུ་ལས་སྐྱེས
གཞུགུ	གཞུག་གུ
ཞྱུང	གཞུང
གཞོགསུ	གཞོགས་སུ
གཞོཊུ	གཞོགས་སུ
གཞོགསློང	གཞོགས་སློང
གཞོངསྤྱོད	གཞོངས་སྤྱོད
ཞོནུསློབསིག	གཞོན་དུས་སློབས་ཤིག
གཞོནུཾ	གཞོན་ནུ་མ
གཞོནུ	གཞོན་ནུ
གཞྱོནུ	གཞོན་ནུ
ཞྱོནུ	གཞོན་ནུ
ཞྱོན	གཞོན
གཞོམེད	གཞོམ་མེད
གཞོལོ	གཞོལ་ལོ
གཟཱབ	གཟབ་གཟབ
གཟབྱ	གཟབ་བྱ
ཟྱའྡགི་	གཟའ་དག་གི་
ཟྱསྤེན	གཟའ་སྤེན
ཟྱ	གཟའ
ཟྱའ	གཟའ
གཟིན	གཟི་ཅན
གཟིདིང་ལྡནའི	གཟི་བརྗིད་དང་ལྡན་པའི
གཟིད	གཟི་བརྗིད
གཟྗིིད	གཟི་བརྗིད
གཟྲིད	གཟི་བརྗིད
ཟིྗདི	གཟི་བརྗིད
ཟྱིགཾངསཟྱིག	གཟིག་གམ་གངས་གཟིག
གཟིགིས	གཟིག་གིས
གཟིུཊ	གཟིགས་འདུག
གཟིཌ	གཟིགས
ཟྱིཌ	གཟིགས
གཟིམལ	གཟིམ་མལ
གཟོུ	གཟུ་བོ
གཟིུང༌	གཟུ་ཤིང༌
གཟེུར	གཟུག་གཟེར
གཟྯེུར	གཟུག་གཟེར
གཟུགིན་འདུག	གཟུག་གིན་འདུག
གཟུཾས	གཟུགས་ཁམས
གཟུཊན	གཟུགས་ཅན
གཟུན	གཟུགས་ཅན
གཟུཊཾ	གཟུགས་མ
གཟེུ༹ས	གཟུགས་མཛེས
གཟེུཾད་ཁཾས	གཟུགས་མེད་ཁམས
གཟུགེསཾད	གཟུགས་མེད
གཟེུད	གཟུགས་མེད
གཟེུདཾ	གཟུགས་མེད
གཟེུཾད	གཟུགས་མེད
གཟུཊི༹ན	གཟུགས་འཛིན
གཟུགསྐུ	གཟུགས་སྐུ
གཟུགསྐུ	གཟུགས་སྐུ
གཟུཊུ	གཟུགས་སྐུ
གཟུགསྡུག	གཟུགས་སྡུག
གཟུགུ	གཟུགས་སྡུག
གཟུཌ	གཟུགས
གཟུགསྡུག	གཟུགས་སྡུག
གཟུངིན	གཟུང་འཛིན
གཟིུང༹ན	གཟུང་འཛིན
གཟུངསྔཊ	གཟུངས་སྔགས
གཟེརཾ	གཟེར་མ
གཟེརོ	གཟེར་རོ
ཟྱེར	གཟེར
ཟྱེོང	གཟོང
ཟྱོད	གཟོད
གཡགིས	གཡག་གིས
ཡྱརྶ	གཡག་སར
ཡྱང	གཡང
གཡབོ	གཡབ་མོ
ཡྱར	གཡར
གཡྱོན	གཡས་གཡོན
གཡྱོགས	གཡས་ཕྱོགས
གཡསུ	གཡས་སུ
ཡྱསྐོརུ	གཡས་སྐོར་དུ
གཡོོུུ༹	གཡུ་མཚོ
གཡྲུག	གཡུ་འབྲུག
གཡུ་ལེཊ་པ	གཡུ་ལེགས་པ
གཡུངན	གཡུང་དྲུང་ཅན
གཡྲུང༌	གཡུང་དྲུང༌
གཡྲུང	གཡུང་དྲུང
གཡུལས	གཡུལ་ལས
གཡེརཾ	གཡེར་མ
ཡྱྕོན	གཡོ་ཅན
ཡྱོ	གཡོ
ཡྱོ་	གཡོག་
གཡོཌ	གཡོགས
གཡོནུ	གཡོན་དུ
ཡྱོནུ	གཡོན་དུ
གཡྱཽཊ	གཡོན་ཕྱོགས
ཡྱོན	གཡོན
གཡོསྣོད	གཡོས་སྣོད
གརསས	གར་གསས
གརབྲེལ	གར་འབྲེལ
གལྖེནི་	གལ་ཆེན་ནི་
གལྖེའོ་	གལ་ཆེའོ་
གལྟེ	གལ་ཏེ
གཤཌ	གཤགས
གཤངོ	གཤང་གཤོང
གཤཾལ	གཤམ་གསལ
གཤིནི	གཤིན་གྱི
གཤིནྱི	གཤིན་གྱི
གཤིནོ	གཤིན་པོ
གཤིནེདེ	གཤིན་རྗེ་གཤེད
གཤིེེནད	གཤིན་རྗེ་གཤེད
གཤྱིནེདེ	གཤིན་རྗེ་གཤེད
ཤྱིེནད	གཤིན་རྗེ་གཤེད
གཤིནེ	གཤིན་རྗེ
གཤྱིནེ	གཤིན་རྗེ
གིཤེན	གཤིན་རྗེ
ཤྱིནེ	གཤིན་རྗེ
གཤིབྱ	གཤིབ་བྱ
གཤཻ	གཤེ་གཤེ
གཤེགསོུལ	གཤེགས་སུ་གསོལ
གཤེཊོུལ	གཤེགས་སུ་གསོལ
གཤེགསོ	གཤེགས་སོ
ཤྱེགསོ	གཤེགས་སོ
གཤེཌ	གཤེགས
ཤྱེགས	གཤེགས
གཤེདུར	གཤེད་དུར
གཤེནབ	གཤེན་རབ
གཤེནརབས	གཤེན་རབས
ཤྱེན	གཤེན
གཤོལྕགས	གཤོལ་ལྕགས
གཤོལྡན	གཤོལ་ལྡན
གསྲུབསློགྶྲུབས	གས་སྲུབས་སློག་སྲུབས
གསྲུབས	གས་སྲུབས
སྱགཅོདེ་	གསག་གཅོད་དེ་
སྱཌ	གསགས
སྱང་	གསང་
སྱངཁང	གསང་ཁང
སྱངཁུང	གསང་ཁུང
སྱངཁེབསྔྃཌ	གསང་ཁེབས་གསང་སྔགས
སྱངནྱད	གསང་གནད
སྱངནྱས	གསང་གནས
སྱངེན	གསང་ཆེན
སྱངེན	གསང་ཆེན
སྱངབང	གསང་དབང
སྱངའི་	གསང་བའི་
སྱངའིསུང	གསང་བའི་གསུང
སྱངའིདགོ་	གསང་བའི་བདག་པོ་
སྱངའིདགོ	གསང་བའི་བདག་པོ
སྱངའི	གསང་བའི
སྱངརྡ	གསང་བརྡ
སྱངཾཚན	གསང་མཚན
སྱངཾཛོད	གསང་མཛོད
སྱངཚིག	གསང་ཚིག
སྱངའདུསིཾསྐྱོད	གསང་འདུས་མི་བསྐྱོད
གསངརྟཌ	གསང་རྟགས
གསྔྃཌསྱརྙིང	གསང་སྔགས་གསར་རྙིང
གསྔཌ	གསང་སྔགས
གསྔྃཌ	གསང་སྔགས
གསྔཊ	གསང་སྔགས
གསྔཾགས	གསང་སྔགས
གསྔཾཊ	གསང་སྔགས
གསྃསྟེ་	གསང་སྟེ་
སྱངསྤྱོདཤངཅྱིདོར	གསང་སྤྱོད་བཤང་གཅི་འདོར
སྱངསྦེད	གསང་སྦེད
སྱངསློབ	གསང་སློབ
སྱང	གསང
སྱངྣས	གསངས་ནས
སྱདརརྩཾསྱང	གསད་པར་བརྩམས་ཀྱང
སྱད	གསད
སྱནས	གསན་ནས
གསནས	གསན་ནས
སྱནཞེསནྱང	གསན་བཞེས་གནང
སྱན་བྱ	གསན་བྱ
སྱན	གསན
སྱབྱིན	གསབ་ཀྱིན
སྱབཚིགིསྱབ	གསབ་ཚིག་གིས་གསབ
སྱའ་ཾ	གསའ་མ་
སྱརྠོགསརསྤྲོསྱས	གསར་ཐོག་གསར་སྤྲོས་བྱས
སྱརུ	གསར་དུ
སྱརཏོད	གསར་བཏོད
སྱརྯོསྱརའོངསྱརོའོ	གསར་བཟོས་གསར་འོངས་གསར་བཟོའོ
སྱརྗེ་	གསར་བརྗེ་
གསརྦུ	གསར་བུ
སྱརབྱུང	གསར་བྱུང
སྱརཾ	གསར་མ
སྱརགྱུར	གསར་འགྱུར
སྱརྙིང	གསར་རྙིང
སྱརྐྱེསྱརགྲོཌ	གསར་སྐྱེས་གསར་གྲོགས
སྱརྐྲུན	གསར་སྐྲུན
སྱར	གསར
སྱལཁཏོདེ་	གསལ་ཁ་བཏོད་དེ་
སྱལཁུངསྒེའུཁུང	གསལ་ཁུང་སྒེའུ་ཁུང
སྱལནས	གསལ་གནས
སྱལྖཐོན	གསལ་ཆ་ཐོན
སྱལཀྲོལཾཛད	གསལ་བཀྲོལ་མཛད
སྱལཏབ	གསལ་བཏབ
སྱལའི	གསལ་བའི
སྱལྒྲཌ	གསལ་བསྒྲགས
སྱལྱེདི	གསལ་བྱེད་ཀྱི
སྱལྱེདབྱངསཅསྲོག	གསལ་བྱེད་དབྱངས་བཅས་སྲོག
སྱལྱེདབྱངསཾདེ	གསལ་བྱེད་དབྱངས་མེད
སྱལྱེདཾ	གསལ་བྱེད་དམ
སྱལྱེཾགི	གསལ་བྱེད་མིག
སྱལྱེད	གསལ་བྱེད
སྱལཾཆྱོ་	གསལ་མཆོག
སྱལཾཐོང	གསལ་མཐོང
སྱལཾཛད	གསལ་མཛད
སྱལེཾ	གསལ་མེ
སྱལྮག	གསལ་ཞག
སྱལདེབས	གསལ་འདེབས
སྱལྱསགྲངྣྱས	གསལ་ཡས་གྲངས་གནས
གསལྱལྱི	གསལ་རྒྱལ་གྱི
གསལྱལ	གསལ་རྒྱལ
སྱལྱལ	གསལ་རྒྱལ
སྱལརྗེན	གསལ་རྗེན
གསལམེ	གསལ་ལམ་མེ
གསལཱམ	གསལ་ལམ་ལམ
སྱཾལཾ་	གསལ་ལམ་ལམ་
སྱལེ	གསལ་ལེ
གསལོ	གསལ་ལོ
སྱལྡན	གསལ་ལྡན
སྱལྷིངེ་	གསལ་ལྷིང་ངེ་
སྱལྴིངགིརྩེ་	གསལ་ཤིང་གི་རྩེ་
སྱལྟོང	གསལ་སྟོང
སྱལྣང	གསལ་སྣང
སྱལྶྤུངསྱི་	གསལ་སྤུངས་ཀྱི་
སྱལ	གསལ
སྱསོཾ་	གསས་མོ་
གསསར	གསས་མཁར
སྱས	གསས
སྱིགིནསྱིཌ	གསིག་གིན་གསིགས
སྱིངགིན	གསིང་གིན
གསིངསྴིག	གསིངས་ཤིག
སྱིར	གསིར
སྱིལྦ	གསིལ་བ
སྱིལྦའོ་	གསིལ་བའོ་
སྱིལ	གསིལ
སྱུགྯོས	གསུག་ཟོས
སྱཁུངསགང་	གསུང་ཁུངས་གང་
གསུང་དོུལ	གསུང་དུ་གསོལ
སྱུངགྲོས	གསུང་བགྲོས
སྱུངཤད	གསུང་བཤད
གསུྃབུཾ	གསུང་འབུམ
གསུབ	གསུང་རབ
སུྃབ	གསུང་རབ
གསུབ	གསུང་རབ
གསྱརྩོཾ	གསུང་རྩོམ
སྱུངན	གསུང་ལན
གསུངྶྐྱེས	གསུང་སྐྱེས
གསུྃསྒྲོས	གསུང་སྒྲོས
སྱང	གསུང
སྱུངསྱངསྱུངྣས	གསུངས་ཀྱང་གསུངས་ནས
སྱུངསོ་	གསུངས་སོ་
གསུངསོ	གསུངས་སོ
གསུངསོ	གསུངས་སོ
གསྱིརེ་	གསུབ་བའི་ཕྱིར་ཏེ་
སྱུབ	གསུབ
སྱུབསིག	གསུབས་ཤིག
༣དུ	གསུམ་དུ
གསུཾ་དུ	གསུམ་དུ
ཉྲི	གསུམ་ནི
ཉྲའི་	གསུམ་པའི་
གསུཾར	གསུམ་པར
གསེུཾད	གསུམ་མེད
གསུམོ	གསུམ་མོ
གསུཾ༹ན	གསུམ་ཚན
གསུཾ	གསུམ
གསུརཀརསུར	གསུར་དཀར་གསུར་
གསུརྔོ་	གསུར་བསྔོ་
གསུརྫསུར	གསུར་རྫ་གསུར
གསུསྱིཾ་	གསུས་ཁྱིམ་
སྱུསོ་ེ	གསུས་པོ་ཆེ་
སྱེ་	གསེ་
སྱེ་	གསེ་
སྱེ་	གསེ་
སྱེགཀདདོ་	གསེག་ཀ་དོད་
སྱེགཅོད	གསེག་གཅོད
སྱེགྲི་	གསེག་གྲི་
སྱེགསོ	གསེག་དགོས
སྱེགཾ་	གསེག་མ་
སྱེག་ཾེརུང	གསེག་མི་རུང
སྱེགལུཾ	གསེག་ལམ་དུ
སྱེག	གསེག
སྱེངཕྲགསེངར	གསེང་ཕྲག་གསེང་བར
སྱེངཤོར	གསེང་ཤོར
སྱེདྱིན	གསེད་ཀྱིན
སྱེདཀྲོལ	གསེད་ཀྲོལ
སྱེདཾཁན	གསེད་མཁན
སྱེབྟུསྡད	གསེབ་ཏུ་བསྡད
སྱེབངོ	གསེབ་བོང
སྱེབ	གསེབ
སྱེབ	གསེབ
སྱེརཀོངཾ	གསེར་ཀོང་ངམ
སྱེརཁྲི་	གསེར་ཁྲི་
སྱེརདུང	གསེར་གདུང
སྱེརདུབ	གསེར་གདུབ
སྱེརཤྱའཾ	གསེར་གཤའ་མ
སྱེརྱི་	གསེར་གྱི་
གསེརན	གསེར་ཅན
སྱེརྖབ	གསེར་ཆབ
སྱེརྖུ	གསེར་ཆུ
སྱེརྖོས	གསེར་ཆོས
སྱེརཐཾ	གསེར་ཐམ
སྱེརཐུབ	གསེར་ཐུབ
གསེརོག	གསེར་ཐོག
གསེརོད	གསེར་ཐོད
སྱེརཙོ་ཾ	གསེར་བཙོ་མ་
སྱེརཾཁར	གསེར་མཁར
སྱེརཾངལྕན	གསེར་མངལ་ཅན
སྱེརདབྕནཁའྡིང	གསེར་འདབ་ཅན་མཁའ་ལྡིང
སྱོརིཌ	གསེར་རིགས
སྱེརྐོ	གསེར་རྐོ
སྱེརྐོང	གསེར་རྐོང
སྱེརྡོ	གསེར་རྡོ
སྱེརྣ་	གསེར་རྣ
སྱེརལྡནཾའཾ	གསེར་ལྡན་མའམ
སྱེརལྡན	གསེར་ལྡན
སྱེརསྐུ	གསེར་སྐུ
སྱེརྐུད	གསེར་སྐུད
སྱེརྐུད	གསེར་སྐུད
གསྐེུརད	གསེར་སྐུད
གསྐྱཻརཾས	གསེར་སྐྱེམས
གསྐྱེརེཾས	གསེར་སྐྱེམས
གསྱེརེསཾ	གསེར་སྐྱེམས
སྱེརེསཾ	གསེར་སྐྱེམས
སྱེརཾ	གསེར་སྐྱེམས
སྱཽརཾ	གསེར་སྐྱེམས
སྱེརསྦྱངསཙོཾ	གསེར་སྦྱངས་བཙོ་མ
སྱེར	གསེར
སྱེར	གསེར
སྱེལ	གསེལ
སྱེསྯིན	གསེས་ཟིན
སྱེས	གསེས
སྱོཐིགསོསྤྱད	གསོ་ཐིག་གསོ་སྤྱད
སྱོཔྱད	གསོ་དཔྱད
གསོུ	གསོ་བུ
སྱོདེ	གསོ་བྱེད
སྱོཾཁན	གསོ་མཁན
གཙྶྐྱོངོ	གསོ་སྐྱོང
གཙྶྐྱོངོ	གསོ་སྐྱོང
སྱོསྦྱོངོ་	གསོ་སྦྱོང་
སྱོསྦྱོངཕཌ	གསོ་སྦྱོང་འཕགས
སྱོ	གསོ
སྱོགསོབ	གསོག་གསོབ
སྱོགིན	གསོག་གིན
སྱོགིནསྱོགྲསྟེ་ཐོ་	གསོག་གིནགསོག་ཁྲ་སྟེ་ཐོ་
སྱོགཇོགསོག	གསོག་འཇོག་གསོག
སྱོགྲྫུ	གསོག་རྫུ
སྱོག	གསོག
སྱོངོ་	གསོང་བོ་
སྱོངསིག	གསོངས་ཤིག
སྱོདྱིན	གསོད་ཀྱིན
གསོདཾ	གསོད་ནམས
སྱོདར	གསོད་པར
སྱོདོད	གསོད་བྱེད
སྱོད	གསོད
སྱོནྕིགཚེ་	གསོན་ཅིག་ཚེ་
གསོནོ	གསོན་པོ
སྱོནོར	གསོན་པོར
སྱོབཟུཌ	གསོབ་གཟུགས
སྱོཾ་	གསོམ་
སྱོརསྐོརནསྦུ	གསོར་བསྐོར་ནས་བུ
སྱོལཁ	གསོལ་ཁ
སྱོལཁང	གསོལ་ཁང
སྱོལཟིསཾཆོད	གསོལ་གཟིམས་མཆོད
གསཽན	གསོལ་དཔོན
སྱོལཆོཾདབྱེད	གསོལ་མཆོད་བྱེད
སྱོལངི	གསོལ་ཞིང
སྱོལྲསྱོལ	གསོལ་རསས་གསོལ
སྱོལོཾཆོདོ་	གསོལ་ལོ་མཆོད་
སྱོལྟོན	གསོལ་སྟོན
སྱོལསྨན	གསོལ་སྨན
སྱོལ	གསོལ
སྱོསྲུགསོསྱ་	གསོས་ཕྲུག་གསོས་བྱ་
སྱོསིགསྣོས	གསོས་ཤིག་གསོས་ནས
སྱོསུ	གསོས་སུ
སྱོས	གསོས
གིམིཌ་	གི་དམིགས་
གངིེན	གིང་ཆེན
གིངེན	གིང་ཆེན
གིངོ	གིང་ཕོ
གིངོ	གིང་མོ
གིསཟོས	གིས་བཟོས
གིསྒྱུར	གིས་བསྒྱུར
གུལུ	གུ་གུལ
གུུལ	གུ་གུལ
གུགོ་པ	གུ་དོག་པ
གུགེ	གུག་གེ
གུངསྱེང	གུང་གསེང
གུཾ	གུང
གུདུ	གུད་དུ
གུཾ	གུམ
གུཾས	གུམས
གུརང་	གུར་ཁང་
གུརང	གུར་ཁང
གུརཾ	གུར་གུམ
གུརམ	གུར་གུམ
གུགོ	གུར་ཐོག
གོུག	གུར་ཐོག
གུརུ	གུར་བུ
གུརལིསུམོ	གུར་ལི་གསུམ་མོ
གུུལ	གུལ་གུལ
གུསདུད	གུས་འདུད
གུསྦྱོར	གུས་སྦྱོར
གེཨོད	གེ་ཁོད
གེཊ་༡	གེགས་གཅིག
གེགསེལ	གེགས་སེལ
གོནས	གོ་གནས
གྖཽད་	གོ་ཆོད་
གོངཾ	གོང་མ
གློའི་	གོ་ལའི་
གློ	གོ་སླ
གོངྑུར	གོང་ཁུར
གོངཱོག	གོང་འོག
གསོན་གཤིན	གོན་པོ་དང་གཤིན་པོ
གོཾས་པ	གོམས་པ
གོསཾ་པ	གོམས་པ
གོཾསྲོལ	གོམས་སྲོལ
གོརུ	གོར་བུ
གོལཏྱོཌའིསྒྲ	གོལ་གཏོགས་པའི་སྒྲ
གོསུཾ	གོས་བསུམ
གོསུ	གོས་སུ
གོསེར	གོས་སེར
གོསྒབ	གོས་སྒབ
གོསྔོན	གོས་སྔོན་ཅན
གྱལོེེ	གྱ་ལེ་གྱོལ་ལེ
གྱལོ	གྱལ་གྱོལ
གྱུགྱུག	གྱུག་གྱུག
གྱུརིག	གྱུར་ཅིག
གྱིུག	གྱུར་ཅིག
གྱུརིགུ	གྱུར་ཅིག་གུ
གྱིུརག	གྱུར་ཅིག
གྱུརོ	གྱུར་རོ
གྱེསོ	གྱེས་སོ
གྱོངྃནི	གྱོང་མིན
གྱོནས	གྱོན་ནས
གྱོསྒྱུག	གྱོས་སྒྱུག
གྲཌ་	གྲགས་
གྲཌ	གྲགས
གྲངར	གྲང་ངར
གྲངེདར	གྲང་མེད་པར
གྲངེད	གྲང་མེད
གྲངན	གྲངས་ཅན
གྲངདེར	གྲངས་མེད་པར
གྲངེད	གྲངས་མེད
གྲཾས	གྲངས
གྲིུག	གྲི་གུག
གྲིུམ	གྲི་གུམ
གྲི་ཐོཌ	གྲི་ཐོགས
གྲིྃདུང་	གྲི་མདུང་
གྲིབསིལ	གྲིབ་བསིལ
གྲིབྃཚས	གྲིབ་མཚམས
གྲིབྐཾ་	གྲིབ་སྐམ་
གྲུགུ	གྲུ་གུ
གྲུཟིངས	གྲུ་གཟིངས
གྲིུངས	གྲུ་གཟིངས
གྲུསུཾཊ	གྲུ་གསུམ
གྲིུ	གྲུ་བཞི
གྲོུྃ	གྲུ་མོ
གྲིུན	གྲུ་ཟིན
གྲིུ༹ན	གྲུ་འཛིན
གྲིུན	གྲུ་འཛིན
གྲོུན	གྲུ་ཡོན
གྲུབྖེན	གྲུབ་ཆེན
གྲུབེན	གྲུབ་ཆེན
གྲེུན	གྲུབ་ཆེན
གྲུབྙི	གྲུབ་ཉི
གྲུབོ	གྲུབ་ཐོབ
གྲོུབ	གྲུབ་ཐོབ
གྲུབོ	གྲུབ་བོ
གྲུབོག	གྲུབ་མཆོག
གྲུཾའ	གྲུབ་མཐའ
གྲོནི	གྲོ་བཞིན
གྲོིན	གྲོ་བཞིན
གྲོགོ	གྲོག་པོ
གྲོགོཾ	གྲོག་མོ
གྲོཊོ	གྲོགས་པོ
གྲོཊོ	གྲོགས་མོ
གྲོཊ	གྲོགས
གྲོཌ་	གྲོགས་
གྲོངེར	གྲོང་ཁྱེར
གྲོརེ	གྲོང་ཁྱེར
གྲོེངར	གྲོང་ཁྱེར
གྲོེར	གྲོང་ཁྱེར
གྲོལར	གྲོང་བར
གྲོངལ	གྲོང་རྡལ
གྲོནྖུང	གྲོན་ཆུང
གྲོལོ	གྲོལ་ལོ
གྲྭགཟུཊ	གྲྭ་གཟུགས
གྲྭལྔི་	གྲྭ་ལྔའི
གླངེན	གླང་ཆེན
གླངོན	གླང་པོ་ཅན
གླངོེ	གླང་པོ་ཆེ
གློངེའི	གླང་པོ་ཆེའི
གླངོ	གླང་པོ
གླངེན	གླན་ཆེན
གླིངྠོགྃ	གླིང་ཐོག་མ
གླིངཕྲན་༨	གླིང་ཕྲན་བརྒྱད
གླིངྲན	གླིང་ཕྲན
གླུཞས	གླུ་གཞས
གླུར	གླུ་གར
གླེཾ	གླེགས་བམ
གླེམ	གླེགས་བམ
གླེགསུ	གླེགས་བུ
གླེཌ་	གླེགས་
གླེྃཞིའྡིེ་	གླེང་གཞིའི་སྡེ་
གླེབྱ	གླེབ་བྱ
གླེབྱེད	གླེབ་བྱེད
གློཅོང	གློ་གཅོང
གློསང	གློ་གསང
གློུརུ	གློ་བུར་དུ
གློུར	གློ་བུར
གློུར	གློ་བུར
གློུར	གློ་འབུར
གློར	གློར
ངྼོ	ང་རོ
ང	ང
ངགང༌	ངག་དབང༌
ངངམ་ཤུགས	ངང་ངམ་ཤུགས
ངངུར	ངང་ངུར
ངངི	ངང་རིང
ངནྱང	ངན་ཀྱང
ངནོ	ངན་ངོན
ངནྲོ	ངན་འགྲོ
ངནསྒྲེཌ	ངན་སྒྲེགས
ངཾས	ངམས
ངརབྲེལཚཾས	ངར་འབྲེལ་མཚམས
ངུག	ངུ་ངག
ངུརིལ	ངུར་རིལ
ངུརིག	ངུར་སྨྲིག
ངིུག	ངུར་སྨྲིག
ངཻས	ངེས་ངེས
ངེསའི	ངེས་པའི
ངེསར	ངེས་པར
ངེསུ	ངེས་པར་དུ
ངེསྙེད	ངེས་རྙེད
ངེསེ	ངེས་ཤེས
ངེེས	ངེས་ཤེས
ངེསྲེག	ངེས་སྲེག
ངེསོ	ངེས་སོ
ངཽ༌	ངོ་བོ
ངོ༹རན	ངོ་མཚར་ཅན
ངོ༹རེད	ངོ་མཚར་མེད
ངོཾ༹ར	ངོ་མཚར
ངོ༹ར	ངོ་མཚར
ངོཾཚར	ངོ་མཚར
ངོ༹བ	ངོ་ཚབ
ངོསྲེ་	ངོ་སྲེ་
ངོསུ	ངོས་སུ
ཅླག	ཅ་ལག
ཅགིས	ཅག་གིས
ཅགྲུྃ	ཅག་གྲུམ
ཅགྕགྯོས	ཅག་ཅག་ཟོས
ཅགཀར	ཅག་དཀར
ཅངལ	ཅང་ངལ
ཅངོ	ཅང་ཅོང
ཅངྃདེ	ཅང་མེད
ཅནྱི	ཅན་གྱི
ཅནུ	ཅན་དུ
ཅནེ	ཅན་ནེ
ཅནེ་	ཅན་ནོ་
ཅམུ	ཅམ་བུ
ཅནྃདེ	ཅན་མེད
ཅྃར	ཅར་མར
ཅརེ	ཅར་རེ
ཅལོ	ཅལ་ཅོལ
ཅིསུཾ	ཅི་གསུང
ཅིརྲོལ	ཅི་གྲོལ
ཅིོག	ཅི་ཅོག
ཅྲིག	ཅི་དྲག
བིདེརྃཆི་	ཅི་བདེར་མཆི་
ཅིཛོད	ཅི་མཛོད་
ཅིདེྃ	ཅི་མེད
ཅིཙུག	ཅི་ཙུག
ཅིཚུག	ཅི་ཚུག
ཅིདོད	ཅི་འདོད
ཅྲིའི	ཅི་འདྲའི
ཅྟི་	ཅི་ལྟ་
ཅྟིུ	ཅི་ལྟ་བུ
ཅིརྟ	ཅི་ལྟར
ཅྟིར	ཅི་ལྟར
ཅྟིེ	ཅི་སྟེ
ཅིགི	ཅིག་གི
ཅིགིས	ཅིག་གིས
ཅིགྕར	ཅིག་ཅར
ཅིགའི	ཅིག་པའི
ཅིགྴོས	ཅིག་ཤོས
ཅིརང་	ཅིར་ཡང་
ཅིསྱང	ཅིས་ཀྱང
ཅུརྩ་	ཅུ་རྩ་
ཅེུང	ཅུང་པེང
ཅུངཟདརྃ	ཅུང་ཟད་དམར
ཅུཅཟདདྃ	ཅུང་ཟད་དམར
ཅུཟདཙྃ	ཅུང་ཟད་ཙམ
ཅུང༹ད	ཅུང་ཟད
ཅུངད	ཅུང་ཟད
ཅུངཟད	ཅུང་ཟད
ཅུངྯད	ཅུང་ཟད
ཅེུང	ཅུང་སེང
ཅྲཻ	ཅེ་རེ
ཅྱ྄ེང་	ཅེ་སྤྱང་
ཅེརེ	ཅེར་རེ
ཅེསུངས་པ	ཅེས་གསུངས་པ
ཅེསྱ་པ	ཅེས་གསུངས་པ
ཅེུངསོ	ཅེས་གསུངས་སོ
ཅེུངསོ	ཅེས་གསུངས་སོ
ཅེསུངསོ	ཅེས་གསུངས་སོ
ཅེསུང	ཅེས་གསུངས
ཅེསྟན་པ	ཅེས་བསྟན་པ
ཅེསྟཽད	ཅེས་བསྟོད་དོ
ཅེསོ	ཅེས་སོ
ཅེསྒྱུརོ	ཅེས་སྒྱུར་རོ
ཅེསྨྲསོ	ཅེས་སྨྲས་སོ
ཅྟཽ	ཅོ་ཏོ
ཅྠཽ	ཅོ་ཐོ
ཅོཅད	ཅོ་བཅད
ཅློེ་	ཅོ་ལེ་
ཅོགྑེབས	ཅོག་ཁེབས
ཅོགུར	ཅོག་གུར
ཅོགེ	ཅོག་གེ
ཅཽག	ཅོག་ཅོག
ཅོགེཙ	ཅོག་ཙེ
ཅིངྮི་	ཅོང་ཞི་
ཅྼཽང	ཅོང་རོང
ཅོྃ	ཅོམ
ཅོལྖུང་	ཅོལ་ཆུང་
ཅོལེ	ཅོལ་ལེ
ཅོལེབ	ཅོལ་ལེབ
ཅོལོ	ཅོལ་ལོ
ཆཉིྃའི་	ཆ་མཉམ་པའི་
ཆཛིན	ཆ་འཛིན
མྶྡིུགཉཾམ	ཆ་ལུགས་མི་སྡུག་ཉམས
ཆླུཌ	ཆ་ལུགས
ཆལུཊ	ཆ་ལུགས
ཆླུགས	ཆ་ལུགས
ཆླུཊ	ཆ་ལུགས
ཆེིལེ	ཆ་ལེ་ཆིལ་ལེ
ཆས	ཆ་ཤས
ཆེས	ཆ་ཤེས
ཆགྲུམ	ཆག་གྲུམ
ཆཱག	ཆག་ཆག
ཆགག	ཆག་ཆག
ཆགག	ཆག་ཆག
ཆཊ་ཐོཊ	ཆགས་ཐོགས
ཆགསྡང	ཆགས་སྡང
ཆགསྤྱོད	ཆགས་སྤྱོད
ཆཌ	ཆགས
ཆངུ	ཆང་ཆུང
ཆངསིང	ཆང་བསིང
ཆངཞན	ཆང་ཞན
ཆྙཾལ	ཆང་སྙལ
ཆདོན	ཆད་དོན
ཆྡ	ཆད
ཆབཟང༌	ཆབ་བཟང༌
ཆབྲིདདིགྲོས	ཆབ་སྲིད་སྲིད་གྲོས
ཆའྃ	ཆའམ
ཆརབབྨྱུརཐིམོ་	ཆར་བབ་མྱུར་ཐིམ་མོ་
ཆལི	ཆལ་ཆིལ
ཆསུ་ཞུགས	ཆས་སུ་ཞུགས
ཆསུ་ཞུཊ	ཆས་སུ་ཞུགས
ཆིབསུཐབསུ	ཆིབས་བསུ་ཐབ་བསུ
ཆིབསུ	ཆིབས་བསུ
ཆིབསྒྱུར	ཆིབས་བསྒྱུར
ཆིབསྐྱེལ	ཆིབས་སྐྱེལ
ཆཱིལ	ཆིལ་ཆིལ
ཆེུ་བ	ཆུ་ཆེ་བ
ཆེུན	ཆུ་ཆེན
ཆོུད་པ	ཆུ་ཆོད་པ
ཆིུལ	ཆུ་དཀྱིལ
ཆོུ༤	ཆུ་བོ་བཞི
ཆོུ	ཆུ་བོ
ཆྱུ	ཆུ་བྱ
ཆོུ༹ད	ཆུ་ཚོད
ཆིུ༹ན	ཆུ་འཛིན
ཆེུལ	ཆུ་ཤེལ
ཆོུར	ཆུ་སྐོར
ཆོུད	ཆུ་སྟོད
ཆོུད	ཆུ་སྣོད
ཆུད	ཆུ་སྨད
ཆུཾད	ཆུ་སྨད
ཆུསྲདྱིནཾ	ཆུ་སྲད་ཀྱིན་ནམ
ཆྲིུནྖེ	ཆུ་སྲིན་ཆེ
ཆིུན	ཆུ་སྲིན
ཆྲིན	ཆུ་སྲིན
ཆྲིུན	ཆུ་སྲིན
ཆུཌ	ཆུགས
ཆུངུ	ཆུང་ངུ
ཆོུང་	ཆུང་ངོ་
ཆུུང	ཆུང་ཆུང
ཆུངི	ཆུང་བའི
ཆུངང	ཆུང་ཡང
ཆུངྶྲི་	ཆུང་སྲི་
ཆུདྯོསོངང	ཆུད་ཟོས་སོང
ཆུབཉི	ཆུབ་ཉི
ཆུབི	ཆུབ་ཉི
ཆུབྙི	ཆུབ་ཉི
ཆྒེེོ	ཆེ་གེ་མོ
ཆྒོེ་ཆྒོེ	ཆེ་གེ་མོ
ཆྒོེེ་ཆྨོེེ	ཆེ་གེ་མོ
ཆེུང༌	ཆེ་ཆུང༌
ཆེུང	ཆེ་ཆུང
ཆེསེ	ཆེ་ཆེས
ཆེར	ཆེ་བར
ཆེགོ	ཆེ་མཆོག
ཆྱེོག	ཆེ་མཆོག
ཆེགོེན	ཆེ་མཆོག་ཆེན
ཆྱོེ	ཆེ་མཆོག
ཆེངི	ཆེ་ཞིང
ཆེོས	ཆེ་ཤོས
ཆྶྲེི	ཆེ་སྲི
ཆེདུ	ཆེད་དུ
ཆེནོ	ཆེན་པོ
ཆེོ	ཆེན་པོ
ཆོེན	ཆེན་པོ
ཆེནོའི	ཆེན་པོའི
ཆེནོི	ཆེན་པོའི
ཆེནོར	ཆེན་པོར
ཆེནོསློབྲིད	ཆེན་པོས་སློབ་ཁྲིད
ཆེནོཾཟུངསྖེན	ཆེན་མོ་གཟུངས་ཆེན
ཆེནོྃ	ཆེན་མོ
ཆཻམ	ཆེམ་ཆེམ
ཆཻར	ཆེས་ཆེར
ཆྒོ	ཆོ་ག
ཆོེན	ཆོ་ཆེན
ཆྲོུལྃཆོད	ཆོ་ཕྲུལ་མཆོད
ཆྲོུལ	ཆོ་འཕྲུལ
ཆཽ	ཆོ་ལོ
ཆོགའི	ཆོག་པའི
ཆོྃས	ཆོམས
ཆོདརོད	ཆོད་པར་གཅོད
ཆོདར	ཆོད་པར
ཆོཾ	ཆོམ
ཆོསྱི་དབངྱུག	ཆོས་ཀྱི་དབང་ཕྱུག
ཆོསྱི་དབདྱུག	ཆོས་ཀྱི་དབང་ཕྱུག
ཆོསྱངིསིུ	ཆོས་ཀྱི་དབྱིངས་སུ
ཆོསྱིངིསུ	ཆོས་ཀྱི་དབྱིངས་སུ
ཆོསྱི་ཕྱགྱ	ཆོས་ཀྱི་ཕྱག་རྒྱ
ཆོསྱི་འཁཽར	ཆོས་ཀྱི་འཁོར་ལོ
ཆོསྱི་རྒྱལོཾ	ཆོས་ཀྱི་རྒྱལ་མོ
ཆོསྱི་རྗེསུ	ཆོས་ཀྱི་རྗེས་སུ
ཆོསྱི་རྣཾ་གྲངས	ཆོས་ཀྱི་རྣམ་གྲངས
ཆོསྱི	ཆོས་ཀྱི
ཆོསུམ	ཆོས་གསུམ
ཆོསུཾ	ཆོས་གསུམ
ཆོསིད	ཆོས་ཉིད
ཆོསངགེུནྶྡེ་	ཆོས་དང་དགེ་འདུན་སྡེ་
ཆོསྱིངསུ་བསྡུས	ཆོས་དབྱིངས་སུ་བསྡུས
ཆོསྱིངས	ཆོས་དབྱིངས
ཆྱོངིས	ཆོས་དབྱིངས
ཆྱོིངས	ཆོས་དབྱིངས
ཆོསྟན་པ	ཆོས་བསྟན་པ
ཆྱོདེ་རྣྱོར	ཆོས་བྱེད་རྣལ་འབྱོར
ཆྱོདེ	ཆོས་བྱེད
ཆོསཾ༹ས	ཆོས་མཚམས
ཆོས༹ད	ཆོས་མཛད
ཆོས༹ན	ཆོས་ཚན
ཆོསཽར	ཆོས་འཁོར་བསྐོར
ཆཽསར	ཆོས་འཁོར
ཆོསོར	ཆོས་འཁོར
ཆོསེལ	ཆོས་འཕེལ
ཆོསྲུལ	ཆོས་འཕྲུལ
ཆོསྱུང༌	ཆོས་འབྱུང༌
ཆྱོུང	ཆོས་འབྱུང
ཆྱོུང	ཆོས་འབྱུང
ཆོསྱོར	ཆོས་འབྱོར
ཆོསྲེལ	ཆོས་འབྲེལ
ཆོསྱལྲི་	ཆོས་རྒྱལ་ཁྲི་
ཆོསུགས	ཆོས་ལུགས
ཆོསུཊ	ཆོས་ལུགས
ཆོསུ	ཆོས་སུ
ཆོསྐད	ཆོས་སྐད
ཆོསྐུ	ཆོས་སྐུ
ཆོསྐུའི	ཆོས་སྐུའི
ཆོསྐྱོང༌	ཆོས་སྐྱོང༌
ཆོསྐྱོང༌སྲུངཾ	ཆོས་སྐྱོང༌
ཆོསྱོང༌	ཆོས་སྐྱོང༌
ཆྱཽང༌	ཆོས་སྐྱོང༌
ཆཽསྱང	ཆོས་སྐྱོང
ཆོསྐྱོབ་ཀྱིས༹དའི	ཆོས་སྐྱོབ་ཀྱིས་མཛད་པའི
ཆོསྐྱོབསྡུས	ཆོས་སྐྱོབས་སྡུས
ཆོསྒྲོགས	ཆོས་སྒྲོགས
ཆོསྒྲོཊ	ཆོས་སྒྲོགས
ཆོསྟོན	ཆོས་སྟོན
ཆོསྡེ	ཆོས་སྡེ
ཆོསེལ	ཆོས་སྤེལ
ཆོསྤྱོད	ཆོས་སྤྱོད
ཆོསྨན	ཆོས་སྨན
ཆོསྨྲ་བ	ཆོས་སྨྲ་བ
ཆོསྲིད	ཆོས་སྲིད
ཆོསྲུང༌	ཆོས་སྲུང༌
ཇཾ	ཇ་མ
ཇིནི	ཇི་བཞིན
ཇིར	ཇི་ལྟར
ཇྟིར	ཇི་ལྟར
ཇིདིུ	ཇི་སྲིད་དུ
ཇིསྲིདཚོའི	ཇི་སྲིད་འཚོའི
ཇིདི	ཇི་སྲིད
ཇིིད	ཇི་སྲིད
ཇོོ	ཇོ་ཇོ
ཇཽ	ཇོ་བོ
ཇོོ	ཇོ་བོ
ཇཽའི	ཇོ་བོའི
ཇཽཾ	ཇོ་མོ
ཇཽམ	ཇོ་མོ
ཇོོ	ཇོ་མོ
ཇོོོོོོོའ	ཇོབོཇོམོམཇོ་མོ་བཞོབ
ཉྱུ	ཉ་ཀྱུ
ཉྱིྃ་	ཉ་ཁྱིམ་
ཉྒང	ཉ་གང
ཉྒའང	ཉ་གའང
ཉྒའོ	ཉ་གའོ
ཉགཅིག	ཉག་གཅིག
ཉྖུང	ཉ་ཆུང
ཉཱག	ཉག་ཉག
ཉགོ	ཉག་ཉོག
ཉངུ	ཉང་ཉུང
ཉནོས	ཉན་ཐོས
ཐནོས	ཉན་ཐོས
ཉབོ	ཉབ་ཉོབ
ཉཾག	ཉམ་ཐག
ཉེ་བསྟེ	ཉ་བ་སྟེ
ཉྨིག	ཉ་མིག
ཉྨིདྖེ	ཉ་མིད་ཆེ
ཉོྃ	ཉ་མོ
ཉྨོ	ཉ་མོ
ཉཚང	ཉ་ཚང
ཉཚེས	ཉ་ཚེས
ཉཛིནབྱེདེ	ཉ་འཛིན་བྱེད་དེ
ཉླྕིབས	ཉ་ལྕིབས
ཉླྟོ	ཉ་ལྟོ
ཉྐྱོབ	ཉ་སྐྱོབ
ཉྟོངདྱད	ཉ་སྟོང་བརྒྱད
ཉགཅིག	ཉག་གཅིག
ཉགེ	ཉག་གེ
ཉྠག	ཉག་ཐག
ཉགྲ	ཉག་ཕྲ
ཉགྲནྃདའ	ཉག་ཕྲན་མདའ
ཉགྠྃལི	ཉག་མཐིལ
ཉགྃདའ	ཉག་མདའ
ཉགོྃ་	ཉག་མོ་མ
ཉགྡོ	ཉག་རྡོ
ཉགླ	ཉག་ལ
ཉགིང	ཉག་ཤིང
ཉགྲང	ཉག་སྲང
ཉངིར	ཉང་ཁྲིར
ཉེང	ཉང་ངེ
ཉཾ	ཉང
ཉནོསྱི	ཉན་ཐོས་ཀྱི
ཉནྠོསྱི	ཉན་ཐོས་ཀྱི
ཉོསི	ཉན་ཐོས་ཀྱི
ཉནསྡེ	ཉན་ཐོས་སྡེ
ཉོསྡེ	ཉན་ཐོས་སྡེ
ཉནོསློབ	ཉན་ཐོས་སློབ
ཉནྠོས	ཉན་ཐོས
ཉོས	ཉན་ཐོས
ཉནྱེདབངོ	ཉན་བྱེད་དབང་བོ
ཉནྻིག	ཉན་ཡིག
ཉནྲང	ཉན་རང
ཉྲང	ཉན་རང
ཉནྣ	ཉན་རྣ
ཉབྙོབ	ཉབ་ཉོབ
ཉེབ	ཉབ་བེ
ཉྃཁྱིལ	ཉམ་ཁྱིལ
ཉྖུྃང	ཉམ་ཆུང
ཉྃསེདེྃ	ཉམ་ཉེས་མེད
ཉྃག	ཉམ་ཐག
ཉྠྃག	ཉམ་ཐག
ཉམན	ཉམ་དམན
ཉམས	ཉམ་དམས
ཉྃཚད	ཉམ་ཚད
ཉྃ	ཉམ
ཉྃསྲིད	ཉམས་ཁྲིད
ཉྃསོ	ཉམས་གསོ
ཉྃསྒུད	ཉམས་གུད
ཉྃསྒྲིབ	ཉམས་གྲིབ
ཉྃསླུ	ཉམས་གླུ
ཉྃསྖགྖེ	ཉམས་ཆག་ཆེ
ཉྃསྖེནསོ	ཉམས་ཆེན་པོས
ཉྕོྃས	ཉམས་བཅོས
ཉྃསྗིད	ཉམས་བརྗིད
ཉྃསྟས	ཉམས་བརྟས
ཉྃསྱེདྱི	ཉམས་བྱེད་ཀྱི
ཉྃསགུྃར	ཉམས་མགུར
ཉྃསྃཚར	ཉམས་མཚར
ཉྃསྃདེ	ཉམས་མེད
ཉཾསགུར	ཉམས་མགུར
ཉྃསྲོངོན	ཉམས་མྱོང་མངོན
ཉམྱོང	ཉམས་མྱོང
ཉྃསཚོད	ཉམས་ཚོད
ཉྃསྱིངྖེ	ཉམས་འགྱིང་ཆེ
ཉྃསྱུར	ཉམས་འགྱུར
ཉྃསཛིནའི	ཉམས་འཛིན་པའི
ཉྃསྻིག	ཉམས་ཡིག
ཉྃསྒྱུད	ཉམས་རྒུད
ཉྃསྙིང་	ཉམས་རྙིང་
ཉྃསྟོངཕེལ	ཉམས་རྟོགས་འཕེལ
ཉྃསརྩལ	ཉམས་རྩལ
ཉཾསེན	ཉམས་ལེན
ཉྃནེ	ཉམས་ལེན
ཉྃསླེན	ཉམས་ལེན
ཉྃསྡན	ཉམས་ལྡན
ཉྃསྴར	ཉམས་ཤར
ཉྃསད	ཉམས་སད
ཉྃསུ	ཉམས་སུ
ཉམསུ	ཉམས་སུ
ཉཾསུ	ཉམས་སུ
ཉཾསོ	ཉམས་སོ
ཉྃསྟབས	ཉམས་སྟབས
ཉྃསྟོབསྖེ	ཉམས་སྟོབས་ཆེ
ཉཾསྟོབས	ཉམས་སྟོབས
ཉཾསྣང༌	ཉམས་སྣང༌
ཉྃསྨད	ཉམས་སྨད
ཉྃསྨོད	ཉམས་སྨོད
ཉྃས	ཉམས
ཉརྱེད	ཉར་བྱེད
ཉརྃ་	ཉར་མ་
ཉརཚཌ་	ཉར་ཚགས་
ཉརཛིན	ཉར་འཛིན
ཉལྲི	ཉལ་ཁྲི
ཉལྒུར	ཉལ་གུར
ཉལྒོས	ཉལ་གོས
ཉལྱིསགྲོ	ཉལ་གྱིས་འགྲོ
ཉལྖསོཌ་	ཉལ་ཆས་སོགས་
ཉལི	ཉལ་ཉིལ
ཉལྠ	ཉལ་ཐ
ནལྡུད	ཉལ་དུད
ཉལའི	ཉལ་བའི
ཉལྱེདྃཚན	ཉལ་བྱེད་མཚན
ཉལྱེད	ཉལ་བྱེད
ཉལྲོ	ཉལ་འགྲོ
ཉལྲོའི	ཉལ་འགྲོའི
ཉལྡན	ཉལ་ལྡན
ཉནོསྱི	ཉས་ཐོས་ཀྱི
ཉྱིིམོ	ཉི་ཁྱིམ་མོ
ཉྲི	ཉི་ཁྲི
ཉིདུཌ་	ཉི་གདུགས་
ཉིུར	ཉི་གུར
ཉྖི	ཉི་ཆ
ཉྖིད	ཉི་ཆད
ཉིཀྱིལ	ཉི་དཀྱིལ
ཉིགའ	ཉི་དགའ
ཉྲིདོ	ཉི་དྲོད
ཉིོས	ཉི་དྲོས
ཉྲིསོ	ཉི་དྲོས
ཉིུབ	ཉི་ནུབ
ཉིུབ	ཉི་ནུབ
ཉྱིདེ	ཉི་ཕྱེད
ཉིརྙན	ཉི་བརྙན
ཉིསྲོས	ཉི་བསྲོས
ཉིུལྲེ	ཉི་བུལ་བསྲེ
ཉིན་མཚན	ཉི་མ་དང་མཚན་མོ
ཉྨིཕུལ	ཉི་མ་འཕུལ
ཉྨིཤར	ཉི་མ་ཤར
ཉིཾ	ཉི་མ
ཉྨི	ཉི་མ
ཉིྨ	ཉི་མ
ཉིདྃངསྱལ	ཉི་མདངས་གསལ
ཉྨིའིཁོརུག	ཉི་མའི་ཁོར་ཡུག
ཉྨིསཞད	ཉི་མའི་བཞད
ཉྨིའིདྃའདོད	ཉི་མའི་མདའ་འདོད
ཉྨིའིཚད	ཉི་མའི་ཚད
ཉྨིའིདོར	ཉི་མའི་འོད་ཟེར
ཉྨིའིདོ	ཉི་མའི་འོད
ཉྨིའིརྩ	ཉི་མའི་རྩ
ཉྨིའི	ཉི་མའི
ཉྨིའོ	ཉི་མའོ
ཉྨིརླག	ཉི་མར་ལག
ཉྨྃར	ཉི་མར
ཉིདེཾར	ཉི་མེད་པར
ཉིར	ཉི་མྱུར
ཉིུར	ཉི་མྱུར
ཉིཚེའི	ཉི་ཚེ་བའི
ཉིཚེའི	ཉི་ཚེའི
ཉིཟེར	ཉི་ཟེར
ཉླིདྃའི	ཉི་ཟླ་པདྨའི
ཉྱིཁྱིསྃ	ཉི་ཟླ་འཁྱིམས
ཉླི	ཉི་ཟླ
ཉིུར	ཉི་ཞུར
ཉིཁྱིསྃ	ཉི་འཁྱིམས
ཉིཆར	ཉི་འཆར
ཉིདེ	ཉི་འདེ
ཉིཛིན	ཉི་འཛིན
ཉྐིང	ཉི་རྐང
ཉྐིར	ཉི་རྐར
ཉྡིུལ	ཉི་རྡུལ
ཉྡིགོ	ཉི་ལྡོག
ཉིུའིཚིག	ཉི་ཤུ་བའི་ཚིག
ཉིུའིགྲོལ	ཉི་ཤུ་བའི་འགྲོལ
ཉིུརྩ	ཉི་ཤུ་རྩ
ཉིུ	ཉི་ཤུ
ཉིུ	ཉི་ཤུ
ཉིུརྃ་	ཉི་ཤུར་མ་
ཉྐྱིསེ	ཉི་སྐྱེས
ཉིགྣི	ཉིག་ནི
ཉིངྑུ་	ཉིང་ཁུ་
ཉིངྖང་	ཉིང་ཆགས་
ཉིངྟོར	ཉིང་ཏོར
ཉིངགོས	ཉིང་དགོས
ཉིངྦྲན	ཉིང་བྲན
ཉིངྃཚྃས	ཉིང་མཚམས
ཉིངཚ་	ཉིང་ཚ་
ཉིངཁྲུལ	ཉིང་འཁྲུལ
ཉིངླག	ཉིང་ལག
ཉིངྲུལ	ཉིང་སྤྲུལ
ཉིངློབ	ཉིང་སློབ
ཉིདྱིས	ཉིད་ཀྱིས
ཉིདྕག	ཉིད་ཅག
ཉིདང	ཉིད་དང
ཉིདུ	ཉིད་དུ
ཉིནྑ	ཉིན་ཁ
ཉིུང༌	ཉིན་གུང༌
ཉིུང་	ཉིན་གུང་
ཉིནྱ	ཉིན་གླ
ཉིནོཾས	ཉིན་ངོས
ཉིནྖད	ཉིན་ཆད
ཉིནྖས	ཉིན་ཆས
ཉིནྠིར	ཉིན་ཐོར
ཉིནཀར	ཉིན་དཀར
ཉིདངོས	ཉིན་དངོས
ཉིནག	ཉིན་ནག
ཉིནྥྱེ	ཉིན་ཕྱེ
ཉིནྱེདྻོལ	ཉིན་ཕྱེད་ཡུལ
ཉིདེ	ཉིན་ཕྱེད
ཉིནྱོཌ་	ཉིན་ཕྱོགས་
ཉིནྟུད	ཉིན་བསྟུན
ཉིནྱེདབངོ	ཉིན་བྱེད་དནང་བོ
ཉིནྃཁོའི	ཉིན་མཁོའི
ཉིནྃཐརྱེད	ཉིན་མཐར་བྱེད
ཉིནྃཚན	ཉིན་མཚན
ཉིྃཚན	ཉིན་མཚན
ཉིཚན	ཉིན་མཚན
ཉི༹ན	ཉིན་མཚན
ཉིན༹	ཉིན་མཚན
ཉིནོྃ་	ཉིན་མོ་
ཉིནོྃའི་	ཉིན་མོའི་
ཉིནོྃའིདགོ	ཉིན་མོའི་བདག་པོ
ཉིནྠོྃའི	ཉིན་མོའི་མཐའ
ཉིནོྃའིདྲེན	ཉིན་མོའི་འདྲེན
ཉིནོྃའིབྱུཾས	ཉིན་མོའི་འབྱུང་ནས
ཉིནཽཾའི	ཉིན་མོའི
ཉིནོྃའི	ཉིན་མོའི
ཉིནོའི	ཉིན་མོའི
ཉིནོྃརགའྲལ	ཉིན་མོར་དགའ་བྲལ
ཉིནཽཾརདེའི	ཉིན་མོར་བྱེད་པའི
ཉིནཚད	ཉིན་ཚད
ཉིན༹ད	ཉིན་ཚད
ཉིནུཚཌ	ཉིན་ཚུགས་
ཉིནགཟའ	ཉིན་ཞག་གཟའ
ཉིནགཚོཌ་	ཉིན་ཞག་ཚོགས་
ཉིནག	ཉིན་ཞག
ཉིནད	ཉིན་ཞད
ཉིནཁོར	ཉིན་འཁོར
ཉིནྱོངས	ཉིན་འཁྱོངས
ཉིནགྱྃས	ཉིན་འགྱངས
ཉིནཕུལ	ཉིན་འཕུལ
ཉྐིན	ཉིན་རྐུན
ཉིནསེ	ཉིན་རྗེས
ཉིནྟར	ཉིན་ལྟར
ཉིནྐར	ཉིན་སྐར
ཉིནྲེལ	ཉིན་སྦྲེལ
ཉྲིབ	ཉིན་སྲིབ
ཉིལི	ཉིལ་ཉིལ
ཉིལིི	ཉིལ་ལི་ལི
ཉིལེ	ཉིལ་ལེ
ཉིསྑྲི་	ཉིས་ཁྲི་
ཉིསྠོག	ཉིས་ཐོག
ཉིསདྱ	ཉིས་བརྒྱ
ཉིསརྩེཌ་	ཉིས་བརྩེགས་
ཉིསློས	ཉིས་ཟློས
ཉིསྒྱུར	ཉིས་འགྱུར
ཉིསྲེལལོག	ཉིས་འབྲེལ་ཤོག
ཉིསྼི	ཉིས་རི
ཉིསྲྕིནྃ	ཉིས་རིམ་ཅན
ཉིསྒྱུ	ཉིས་རྒྱུ
ཉླིས	ཉིས་ལས
ཉིསླེན	ཉིས་ལེན
ཉིསློག	ཉིས་ལོག
ཉིསྡབ	ཉིས་ལྡབ
ཉིསྐལ	ཉིས་སྐལ
ཉིསྐུལ	ཉིས་སྐུལ
ཉིསྐྲ	ཉིས་སྐྲ
ཉིསྒྲིྃ	ཉིས་སྒྲིམ
ཉིསྟོང	ཉིས་སྟོང
ཉིསྦྲཌ་	ཉིས་སྦྲགས་
ཉིསྦྲེལ	ཉིས་སྦྲེལ
ཉུགྙུག	ཉུག་ཉུག
ཉུངུ་	ཉུང་ངུ་
ཉུངུར	ཉུང་ངུར
ཉུངེ	ཉུང་ངེ
ཉུཾནིག	ཉུང་ཉིན་ཞག
ཉུངང	ཉུང་ཉུང
ཉུངརྣག	ཉུང་དཀར་ནག
ཉུངར	ཉུང་དཀར
ཉུངག	ཉུང་ནག
ཉུངྃ་	ཉུང་མ་
ཉུངཉྃ	ཉུང་མཉམ
ཉུངཐའོ	ཉུང་མཐོའོ
ཉུངཙྃ	ཉུང་ཙམ་
ཉུངཟད་	ཉུང་ཟད
ཉུངྴས	ཉུང་ཤས
ཉུངཤྱེར	ཉུངས་གཤེར
ཉུངསར	ཉུངས་དཀར
ཉུལྙུལ	ཉུལ་ཉུལ
ཉུལོ	ཉུལ་བོ
ཉུལྱེདབྖག	ཉུལ་བྱེད་འདབ་ཆག
ཉུལྃ་	ཉུལ་མ་
ཉུལེ	ཉུལ་ལེ
ཉྖེར	ཉེ་ཆར
ཉེོན	ཉེ་ཉོན
ཉེགའ	ཉེ་དགའ
ཉེབང	ཉེ་དབང
ཉེུ	ཉེ་དུ
ཉྲེུང་	ཉེ་དྲུག་
ཉེའི་	ཉེ་བའི་
ཉེའིཔུང	ཉེ་བའི་དུང
ཉེའིྃཚྃསདེ	ཉེ་བའི་མཚམས་མེད
ཉེའིཚལ	ཉེ་བའི་ཚལ
ཉེའིཆི	ཉེ་བའི་འཆི
ཉེའིཇིག	ཉེ་བའི་འཇིག
ཉེའི	ཉེ་བའི
ཉེརནྱས	ཉེ་བར་གནས
ཉེརྱེད	ཉེ་བར་བྱེད
ཉེརྃཚན	ཉེ་བར་མཚན
ཉེརྃཚོན	ཉེ་བར་མཚོན
ཉེརཕརགྲོ་	ཉེ་བར་འཕར་འགྲོ་
ཉེརྱུ	ཉེ་བར་རྒྱུ
ཉེརསྤྱོད	ཉེ་བར་སྤྱོད
ཉེར	ཉེ་བར
ཉེཐོྃང་	ཉེ་མཐོང་
ཉཚན	ཉེ་ཚན
ཉེཚིག	ཉེ་ཚིག
ཉྮོདེྃར	ཉེ་ཞོ་མེད་པར
ཉྮོསབེནིང་	ཉེ་ཞོས་དབེན་ཞིང་
ཉེཁོན	ཉེ་འཁོན
ཉེརོ	ཉེ་འཁོར
ཉེགྲྃ	ཉེ་འགྲམ
ཉེདབསུ	ཉེ་འདབས་སུ
ཉྱཻད	ཉེ་འབྱེད
ཉྲཻལ	ཉེ་འབྲེལ
ཉེངི	ཉེ་རིང
ཉེརིང	ཉེ་རིང
ཉེ་རྒྱུད	ཉེ་རྒྱུད
ཉེངི	ཉེ་ཤིང
ཉྐེརོ	ཉེ་སྐོར
ཉྐྱེརོ	ཉེ་སྐྱོར
ཉྔེནོ	ཉེ་སྔོན
ཉེདང	ཉེད་དང
ཉེནྑ	ཉེན་ཁ
ཉེནྱིས	ཉེན་གྱིས
ཉྯེནོ	ཉེན་ཟོན
ཉེནགོག	ཉེན་འགོག
ཉེནྒྲིབ	ཉེན་སྒྲིབ
ཉེའུ	ཉེའུ
ཉེརིག	ཉེར་གཅིག
ཉེར༡	ཉེར་གཅིག
ཉྲེ་གཅིག	ཉེར་གཅིག
ཉཻརར	ཉེར་ཉེར
ཉེརྠབེ	ཉེར་ཐུབ
ཉེརསཌ་	ཉེར་བསགས་
ཉེརསྐྲུན	ཉེར་བསྐྲུན
ཉེརསྒྱུར	ཉེར་བསྒྱུར
ཉེརསྡོཌ་	ཉེར་བསྡོགས་
ཉེརྮི་	ཉེར་ཞི་
ཉེརཁུྃ	ཉེར་འཁུམ
ཉེརཇོག	ཉེར་འཇོག
ཉེརབྲོས་	ཉེར་འབྲས་སོ་
ཉེརཚེ	ཉེར་འཚེ
ཉེརཛིན	ཉེར་འཛིན
ཉླེརནྱི	ཉེར་ལེན་གྱི
ཉྲེལྔའི་	ཉེར་ལྔ་བའི་
ཉྲེལྔ	ཉེར་ལྔ
ཉྲེ་ལྔ	ཉེར་ལྔ
ཉེརསྐྱེད	ཉེར་སྐྱེད
ཉེརྱ྄ོད	ཉེར་སྤྱད
ཉེརྱ྄ོད	ཉེར་སྤྱོད
ཉེརྦས	ཉེར་སྦས
ཉེསུྃཇོྃས	ཉེས་གསུམ་འཇོམས
ཉེསྕན	ཉེས་ཅན
ཉེསྖད	ཉེས་ཆད
ཉེསྖར	ཉེས་ཆར
ཉེསངུལ	ཉེས་དངུལ
ཉེསམིཌ་	ཉེས་དམིགས་
ཉེསཤད	ཉེས་བཤད
ཉེསྱས	ཉེས་བྱས
ཉེསྃདེ	ཉེས་མེད
ཉེསཚབས	ཉེས་ཚབས
ཉེསགེལ	ཉེས་འགེལ
ཉེསགོག	ཉེས་འགོག
ཉེསརྩདྖོད	ཉེས་རྩད་ཆོད
ཉླེས	ཉེས་ལས
ཉེསྟུང་	ཉེས་ལྟོང་
ཉེསྐྱེན	ཉེས་སྐྱོན
ཉེསྤྱོོད	ཉེས་སྤྱོད
ཉྖོ	ཉོ་ཆ
ཉྖོས	ཉོ་ཆས
ཉོཚོང	ཉོ་ཚོང
ཉྲཽཌ་	ཉོ་རོགས་
ཉྒྲོུབ	ཉོ་སྒྲུབ
ཉོགེངདུགོ	ཉོག་གེ་གང་འདུག་གོ
ཉཽངས	ཉོང་མོངས
ཉྲཽད	ཉོད་རོད
ཉོནྕིག	ཉོན་ཅིག
ཉོན་༡	ཉོན་ཅིག
ཉཽནངསྱིདྲུག	ཉོན་མོངས་ཀྱི་རྒྱུ་དྲུག
ཉོནོྃངསྱི	ཉོན་མོངས་ཀྱི
ཉཽནངསྕནྱི	ཉོན་མོངས་གྱི
ཉོནོྃདྕིག	ཉོན་མོངས་ཅིག
ཉཽངསྃདེང་	ཉོན་མོངས་མེད་དང་
ཉཽངསྃདེའི	ཉོན་མོངས་མེད་པའི
ཉོོོོོོོོནངས	ཉོན་མོངས་ཚོགས་བཅོམ་མགོན་པོ་ཁྱོད་མཆོད
ཉོངོས	ཉོན་མོངས
ཉཽནངཾས	ཉོན་མོངས
ཉོནོངས	ཉོན་མོངས
ཉོོངས	ཉོན་མོངས
ཉེནོྃངས	ཉོན་མོངས
ཉོངསོ	ཉོན་མོངས
ཉོངོྃས	ཉོན་མོངས
ཉཽྃངས	ཉོན་མོངས
ཉོངོྃས་	ཉོན་མྱོངས་
ཉཽབ	ཉོབ་ཉོབ
ཉོབེ	ཉོབ་བེ
ཉྠོབི	ཉོབ་འཐིབ
ཉོསའི	ཉོས་པའི
ཏཾཁྲོའྃ་	ཏང་ཁྲ་བོའམ་
ཏཱན་ཏཱིག	ཏན་ཏན་ཏིག་ཏིག
ཏིགིས	ཏིག་གིས
ཏིངེཛིན	ཏིང་ངེ་འཛིན
ཏེངཛིན	ཏིང་ངེ་འཛིན
ཏིངི༹ན	ཏིང་ངེ་འཛིན
ཏིངེ༹ནི	ཏིང་ངེ་འཛིན
ཏིིིངིིིནིིི	ཏིང་འཛིན་ཇི་བཞིན་རིག་ཅིང་གཟིགས་ཤིང་འཛིན
ཏིང༹ནི	ཏིང་འཛིན
ཏིངི་ན༹	ཏིང་འཛིན
ཏིངིན༹	ཏིང་འཛིན
ཨིངི༹ན	ཏིང་འཛིན
ཏིངག	ཏིང་ཤག
ཏིངགས	ཏིང་ཤགས
ཏུཤར	ཏུ་ཤར
ཏོགི་བླཽས	ཏོག་གི་བློ་གྲོས
ཏྲེསམ	ཏྲེས་སམ
ཚ་ཞང	ཐ་བོ་དང་ཞང་པོ
ཐྯེཾར	ཐ་མ་ཟེར
ཐགཅོད་པ	ཐག་གཅོད་པ
ཐགིས	ཐག་གིས
ཐགྕུངྯད	ཐག་ཅུང་ཟད
ཐགྣི	ཐག་ནི
ཐགྱེདཀ	ཐག་ཕྱེད་ཀ
ཐགྶྐུད	ཐག་སྐུད
ཐུདཾང	ཐགས་དམ་བསྐང
ཐྱདམ	ཐགས་དམ་བསྐང
ཐངཾ	ཐང་མ
ཐྴིང	ཐང་ཤིང
ཐདྐ	ཐད་ཀ
ཐདུ	ཐད་དུ
ཐདྲང༌	ཐད་དྲང༌
ཐདྶོ	ཐད་སོ
ཐནོ	ཐན་ཐོན
ཐབསྱི	ཐབས་ཀྱི
ཐབསྱ་ཇུསྟོང	ཐབས་བརྒྱ་ཇུས་སྟོང
ཐབཾས	ཐབས་མཁས
ཐབེས	ཐབས་ཤེས
ཐབེས	ཐབས་ཤེས
ཐབསུ	ཐབས་སུ
ཐབསུ	ཐབས་སུ
ཐམོ	ཐམ་ཐོམ
ཐཾ་པ	ཐམ་པ
ཐཾཔ	ཐམ་པ
ཐཾ	ཐམ
ཐྃདི	ཐམས་ཅད་ཀྱི
ཐྃདགེ	ཐམས་ཅད་དགེ
ཐཾད་མྱེན་པ	ཐམས་ཅད་མཁྱེན་པ
ཐྃདསྐྱོབ	ཐམས་ཅད་སྐྱོབ
ཐྃད	ཐམས་ཅད
ཐསྩཾད	ཐམས་ཅད
ཐཾཨད	ཐམས་ཅད
ཐརོ	ཐར་ཐོར
ཐརུ	ཐར་ནུ
ཐརའི	ཐར་པའི
ཐལོཾ	ཐལ་མོ
ཐལྱུར	ཐལ་འགྱུར
ཐལྕག	ཐལ་ལྕག
ཐིགདབ	ཐིག་གདབ
ཐིགདེབསྱེདཾ	ཐིག་འདེབས་བྱེད་ཀྱི
ཐིགེ	ཐིག་ལེ
ཐིགླེ	ཐིག་ལེ
ཐིེག	ཐིག་ལེ
ཐིཾ་པ	ཐིམ་པ
ཐིམོ	ཐིམ་མོ
ཐིཞེསརྡོཚན	ཐིམ་ཞེས་རྡོ་ཚན
ཐྱར	ཐུགས་ཀར
ཐུགིས	ཐུགས་ཀྱིས
ཐུགོངས	ཐུགས་དགོངས
ཐྱདཾན	ཐུགས་དམ་ཅན
ཐུཾདང༌	ཐུགས་དམ་བསྐང༌
ཐྱདཾང	ཐུགས་དམ་བསྐང༌
ཐུཊཾ	ཐུགས་དམ
ཐྱདཾ	ཐུགས་དམ
ཐྱར	ཐུགས་དཀར
ཐུགསེ༹	ཐུགས་བརྩེ
ཐུཊེ༹	ཐུགས་བརྩེ
ཐེུ༹གས	ཐུགས་བརྩེ
ཐེུག༹ས	ཐུགས་བརྩེ
ཐེུ༹ཊ	ཐུགས་བརྩེ
ཐེུགས་ཆེནོ	ཐུགས་རྗེ་ཆེན་པོ
ཐཻུནོ	ཐུགས་རྗེ་ཆེན་པོ
ཐྱོེེན	ཐུགས་རྗེ་ཆེན་པོ
ཐྱེེོནའི	ཐུགས་རྗེ་ཆེན་པོའི
ཐུཊེ	ཐུགས་རྗེ
ཐེུགས	ཐུགས་རྗེ
ཐེུཊ	ཐུགས་རྗེ
ཐྱེ	ཐུགས་རྗེ
ཐྱེའི	ཐུགས་རྗེའི
ཐྱེས	ཐུགས་རྗེས
ཐུཊེའི	ཐུགས་ལེགས་པའི
ཐུཊེ་རིནེ	ཐུགས་ལེགས་རིན་ཆེན
ཐུཊེ	ཐུགས་ལེགས
ཐུཊ	ཐུགས
ཐུཌ་	ཐུགས་
ཐུཌ	ཐུགས
ཐྱས	ཐུགས
ཐཱུང	ཐུང་ཐུང
ཐུངཉཾ	ཐུང་མཉམ
ཐུནསྱེང	ཐུན་གསེང
ཐུནྲུག	ཐུན་དྲུག
ཐུནརུ	ཐུན་བར་དུ
ཐུནི	ཐུན་བཞི
ཐིུན	ཐུན་བཞི
ཐུནཾཚྣྃས	ཐུན་མཚམས་ནས
ཐུནཾ༹ས	ཐུན་མཚམས
ཐིུན	ཐུན་མིན
ཐོུངསོ	ཐུན་མོང་ཆོས
ཐུནོཾང༌	ཐུན་མོང༌
ཐོུང༌	ཐུན་མོང༌
ཐུནོང	ཐུན་མོང
ཐུནཾཨོངས	ཐུན་མོངས
ཐུབེན	ཐུབ་ཆེན
ཐེུན	ཐུབ་ཆེན
ཐུབང	ཐུབ་དང
ཐུབང༌	ཐུབ་དབང༌
ཐུབསྟན	ཐུབ་བསྟན
ཐུབོ	ཐུབ་བོ
ཐུབོ༹ད	ཐུབ་ཚོད
ཐུརཔྱདར	ཐུར་དཔྱད་བར
ཐེོཾད	ཐེ་ཚོམ་མེད
ཐོེེདཾ	ཐེ་ཚོམ་མེད
ཐེོཾ	ཐེ་ཚོམ
ཐོེ	ཐེ་ཚོམ
ཐེགེན	ཐེག་ཆེན
ཐེེགན	ཐེག་ཆེན
ཐེགན	ཐེག་དམན
ཐེགའིཇུགྶྒོ་	ཐེག་པའི་འཇུག་སྒོ་
ཐེགའི	ཐེག་པའི
ཐྲེངས	ཐེའུ་རངས
ཐཻར	ཐེར་ཐེར
ཐེརང	ཐེར་རང
ཐེརྨུཌ	ཐེར་རྨུགས
ཐེལེ༹	ཐེལ་ཚེ
ཐོང	ཐོ་དང
ཐྲོངེས	ཐོ་རེངས
ཐྲོེངས	ཐོ་རེངས
ཐོགིས	ཐོག་གིས
ཐོགུ	ཐོག་གུ
ཐོགྠག	ཐོག་ཐག
ཐོགྃ་	ཐོག་མ་
ཐོགཾར	ཐོག་མར
ཐོགེཾད	ཐོག་མེད
ཐོཨེགད	ཐོག་མེད
ཐོཊེཾད་ཀྱིས༹དའི	ཐོགས་མེད་ཀྱིས་མཛད་པའི
ཐོཊེཾད	ཐོགས་མེད
ཐོགསོ	ཐོགས་སོ
ཐོཌ	ཐོགས
ཐྲོག	ཐོད་ཁྲག
ཐྲོདག	ཐོད་ཁྲག
ཐོདག	ཐོད་ཁྲག
ཐྲོག	ཐོད་ཁྲག
ཐོདར	ཐོད་གར
ཐཽད	ཐོད་ཐོད
ཐྲོེང༌	ཐོད་ཕྲེང༌
ཐྲོདེང༹ལ	ཐོད་ཕྲེང་ཚལ
ཐྲོེདང༹ལ	ཐོད་ཕྲེང་རྩལ
ཐྲདོེང	ཐོད་ཕྲེང
ཐོནྲི	ཐོན་དྲི
ཐོབུས	ཐོབ་དུས
ཐོབའི	ཐོབ་པའི
ཐོབརོག	ཐོབ་པར་ཤོག
ཐབཽརག	ཐོབ་པར་ཤོག
ཐོབར	ཐོབ་པར
ཐོབྱ	ཐོབ་བྱ
ཐོམུ	ཐོམ་བུ
ཐོུར༹ག	ཐོར་གཙུག
ཐོརོག	ཐོར་ཅོག
ཐོསི༹ན	ཐོས་འཛིན
དཀུབ	དཀའ་ཐུབ
དཀའང	དཀའ་དང
དཀའི	དཀའ་བའི
དཀའགྲེལ	དཀའ་འགྲེལ
དཀྲེལ	དཀའ་འགྲེལ
དཀྱད	དཀའ་སྤྱད
དཀའྱ྄ད	དཀའ་སྤྱོད
དཀརྖག	དཀར་ཆག
དཀརགིས	དཀར་ནག་གིས
དཀརོ	དཀར་པོ
དཀོར	དཀར་བོ
དཀོཊ	དཀར་ཕྱོགས
དཀྱོགས	དཀར་ཕྱོགས
དཀརེ	དཀར་མེ
དཀརཾཨོ	དཀར་མོ
དཀརིངགྲོསཟང་	དཀར་ཞིང་འགྲོས་བཟང་
དཀརོལ	དཀར་ཡོལ
དཀོལ	དཀར་ཡོལ
དཀརྩི	དཀར་རྩི
དཀཽག	དཀོན་ཅོག
དཀོནོ	དཀོན་ནོ
དཀཽན	དཀོན་པོ
དཀཽག	དཀོན་མཆོག
དཀོག	དཀོན་མཆོག
དཀཽགསུཾ་ལ་སྐྱབསུ་མཆི	དཀོན་མཆོག་གསུམ་ལ་སྐྱབས་སུ་མཆི
དཀཽགསུཾ	དཀོན་མཆོག་གསུམ
དཀཽནགསུཾ	དཀོན་མཆོག་གསུམ
དཀོོག	དཀོན་མཆོག
དཀཽན	དཀོན་མོ
རྐོན	དཀོན
དཀོརཉྱེར	དཀོར་གཉེར
དཀཽར	དཀོར་ནོར
དཀོོར	དཀོར་ནོར
དཀྱིུང༌	དཀྱིལ་ཀྲུང༌
སྐྱིུང	དཀྱིལ་དཀྲུང
དཀྱིལོར་རྒྱོཾ	དཀྱིལ་འཁོར་རྒྱ་མཚོ
དཀྱིརོ	དཀྱིལ་འཁོར
དཀྱིལོར	དཀྱིལ་འཁོར
དཀྱོིར	དཀྱིལ་འཁོར
དཀྱོིལར	དཀྱིལ་འཁོར
དིརོ	དཀྱིལ་འཁོར
དོིར	དཀྱིལ་འཁོར
དལ	དཀྱིལ
དཀྲུཾའ	དཀྲུམ་མདའ
ཀྲོངསོ	དཀྲོངས་སོ་
དགིས	དག་གིས
དགྱེད	དག་བྱེད
དགྃཚས	དག་མཚམས
དགགཞག	དགག་གཞག
དགབྱ	དགབ་བྱ
དགཱའ	དགའ་དགའ
དགའི	དགའ་བའི
དགའོྃད	དགའ་མེད
དག༹ལ	དགའ་ཚལ
དགའཁྱིལ	དགའ་འཁྱིལ
འགྱིལ	དགའ་འཁྱིལ
དགའདུན	དགའ་འདུན
དགའོ	དགའ་འོ
དགའྡན	དགའ་ལྡན
དགྲོ	དགའ་སྤྲོ
དགུཏོར	དགུ་གཏོར
དགིུ༹ཊ	དགུ་ཚིགས
དགུ	དགུ
དགིུག	དགུང་ཐིག
དགུམོ	དགུམ་མོ
དགིུར	དགུའི་བར
དགེཡོག	དགེ་གཡོག
དགེོམས	དགེ་གོམས
དགེ་སྡིག	དགེ་བ་དང་སྡིག་པ
དགེ་བཱི	དགེ་བའི
དགེར	དགེ་བར
དགེེེེེེེ	དགེ་བཤེས་པེང་གེ་བྲེ་རེ་ཁྱེར
དགེསེ	དགེ་བཤེས
དགེེས	དགེ་བཤེས
དགཻན	དགེ་བསྙེན
དགེནྙེ	དགེ་བསྙེན
དགྙེེན	དགེ་བསྙེན
དགེ༹ན	དགེ་མཚན
དགེུ༹ལ	དགེ་ཚུལ
དགེུནཉུགརྃ	དགེ་འདུན་གཉུག་མར
དགེུན	དགེ་འདུན
དགེུན	དགེ་འདུན
དགེརྩ	དགེ་རྩ
དགེུགས	དགེ་ལུགས
དགེུཊ	དགེ་ལུགས
དགྲེུབ	དགེ་སྒྲུབ
དགླེངོཾ	དགེ་སློང་མ
དགེངོ༌	དགེ་སློང༌
དགླེངོ༌	དགེ་སློང༌
དགླེོང	དགེ་སློང
དགློེང	དགེ་སློང
དགློེང	དགེ་སློང
དེགོང	དགེ་སློང
དགླེངོ	དགེ་སློང
དགོསླགཾ	དགོ་སླག་གམ
དགོངོྃ	དགོང་མོ
དགོངསཾ	དགོངས་སམ
དགོངསོུལོ	དགོངས་སུ་གསོལ་ལོ
རྒོད	དགོད
དགོནས	དགོན་གནས
རྒོནས	དགོན་གནས
རྒོན	དགོན
དགྱཻ	དགྱེ་དགྱེ
དགྱེརོ	དགྱེས་རྡོར
དགྲག	དགྲ་ཁྲག
དགྲཉེན	དགྲ་གཉེན
དགྲོགས	དགྲ་གྲོགས
དགྲེགས	དགྲ་བགེགས
དགྲེཊ	དགྲ་བགེགས
དོགྲམ	དགྲ་བཅོམ་
དགྲོཾ	དགྲ་བཅོམ
གྲོྃ	དགྲ་བཅོམ
དགྲོམ	དགྲ་བཅོམ
དགྲླ	དགྲ་ཟླ
དགླ	དགྲ་ཟླ
དགླ	དགྲ་ཟླ
དངོ་	དང་བོ་
དངོའི་	དང་བོའི་
དངོའི་	དང་བོའི
དངོར	དང་པོར
དངངསྐྲག	དངངས་སྐྲག
དངོཾ	དངོམ
དངོནས	དངོས་གནས
དངོསཞྱིའི	དངོས་གཞིའི
དངོསི	དངོས་གཞི
དངོིས	དངོས་གཞི
དངོུབ༹ལོ	དངོས་གྲུབ་འཚོལ
དངོ་བྲུ༹ལོ	དངོས་གྲུབ་རྩོལ
དངོབརûལོ	དངོས་གྲུབ་རྩོལ
དངོུབ༹ལོ	དངོས་གྲུབ་སྩོལ
ངྲོུབ	དངོས་གྲུབ
ངྲོུབ	དངོས་གྲུབ
དགྲོུབ	དངོས་གྲུབ
དངོསྲུབ	དངོས་གྲུབ
དངྲོུབ	དངོས་གྲུབ
དདྲོུབ	དངོས་གྲུབ
དངཽས	དངོས་པོ
དངོསོ	དངོས་པོ
དངཽས	དངོས་བོ
དངོསེན	དངོས་ཞེན
དངོས་འཇུགསུཾ	དངོས་འཇུག་གསུམ
དངོ༹ནི	དངོས་འཛིན
དངུསུ	དངོས་སུ
དངོསུ	དངོས་སུ
དངོསློབ	དངོས་སློབ
དདའི་	དད་པའི་
དཔགེད	དཔག་མེད
དཔགེཾད	དཔག་མེད
དཔགཚདསྟོང	དཔག་ཚད་སྟོང
དཔངྻིག	དཔང་ཡིག
དཔའེན	དཔའ་ཆེན
དཔའོ	དཔའ་བོ
དཔའོཾ	དཔའ་མོ
དཔོཾའ	དཔའ་མོ
དཔལྱི་ལུང༌	དཔལ་གྱི་ལུང༌
དཔལྱི	དཔལ་གྱི
དཔལེན	དཔལ་ཆེན
དཔལྱེན	དཔལ་ཆེན
དཔལྙི	དཔལ་ཉི
དཔལེ	དཔལ་བེ
དཔལྦེ	དཔལ་བེ
དཔལེ	དཔལ་བེའུ
དཔལྦེའུ	དཔལ་བེའུ
དཔྲེང༌	དཔལ་འཕྲེང༌
དཔལྲེང	དཔལ་འཕྲེང
དཔལར	དཔལ་འབར
དཔལྱོར	དཔལ་འབྱོར
དཔལི༹ན	དཔལ་འཛིན
དཔལོན	དཔལ་ཡོན
དཔལྡན་ལྷོཾ	དཔལ་ལྡན་ལྷ་མོ
དཔལྡན	དཔལ་ལྡན
དཔོུགས	དཔུང་ཆོགས
དཔོུགས	དཔུང་ཚོགས
དཔོུཊ	དཔུང་ཚོགས
དཔྖེའོ	དཔེ་ཆའོ
དཔྱེདཉིསྙནཉྃ	དཔེ་བྱད་གཉིས་སྙན་མཉམ
དཔྱེད	དཔེ་བྱད
དཔེཉྃདི	དཔེ་མཉམ་ཉིད
པྡེ	དཔེ་ལྔ
དཔེརྣ	དཔེར་ན
དཔེརྗོད	དཔེར་བརྗོད
དཔེོད	དཔེར་བརྗོད
དཔེརོ༹ན	དཔེར་མཚོན
དཔོནོག	དཔོན་གཡོག
དཔཽག	དཔོན་གཡོག
དོཔནོག	དཔོན་གཡོག
དཔོནསས	དཔོན་གསས
དཔཽན	དཔོན་པོ
དཔོཾན	དཔོན་པོ
དཔོཾན	དཔོན་མོ
དཔླཽན	དཔོན་སློབ
དཔློན	དཔོན་སློབ
དཔློབོ	དཔོན་སློབ
དཔྱིདུས	དཔྱིད་དུས
དབངེནཾ	དབང་ཆེན་མ
དབངེན	དབང་ཆེན
དབངེན	དབང་ཆེན
དབྲངག	དབང་དྲག
དབྲཾག	དབང་དྲག
དབངོ༌	དབང་པོ
དབངོསི	དབང་པོའི་གནས
དབངོའི	དབང་པོའི
དབྱུངགཾ	དབང་ཕྱུག་མ
དབྱུངག	དབང་ཕྱུག
དབྱུཾག	དབང་ཕྱུག
དབྱུག	དབང་ཕྱུག
དབངོ	དབང་བོ
དབུངར	དབང་བསྐུར
དབུཾར	དབང་བསྐུར
དབྱུར	དབང་བསྒྱུར
དབངོཾ༌	དབང་མོ
དབྱོོངར	དབང་འབྱོར
དབལྡན	དབལ་ལྡན
དབསྔོན	དབང་སྔོན
དབྱུད	དབུ་ཁྱུད
དབོུད	དབུ་ཐོད
དབུཞུགས	དབུ་བཞུགས
དབུསྙུངས་པ	དབུ་བསྙུངས་པ
དབུཾ་བ	དབུ་མ་བ
དབུཾ	དབུ་མ
དབུ༹ད	དབུ་མཛད
དབེུད	དབུ་མེད
དབེུཾད	དབུ་མེད
དབུཊོབ	དབུགས་ཐོབ
དབོུབས	དབུགས་ཐོབ
དབུགསྐྱེས	དབུགས་སྐྱེས
དབུརྡོ	དབུར་རྡོ
དབུལོ	དབུལ་པོ
དབུསྃ་	དབུས་མ་
དབུསྃང་	དབུས་མ་དང་
དབུསུ	དབུས་སུ
དབེནས	དབེན་གནས
དབྱངསྱིསྙདའི་	དབྱངས་ཀྱིས་བསྙད་པའི་སྡེ
དབྱངལ	དབྱངས་གསལ
དབྱརྱི	དབྱར་གྱི
དབྱརོསྮེསྙནྲཌ	དབྱར་ཆོས་ཞེས་སྙན་གྲགས
དབྱརྔ	དབྱར་རྔ
དབྱརྩྭ	དབྱར་རྩྭ
དབྱིགཉེནྱི	དབྱིག་གཉེན་གྱི
དབྱིགཉེནྱིས༹དའི	དབྱིག་གཉེན་གྱིས་མཛད་པའི
དབྱིགཉེནྱིས	དབྱིག་གཉེན་གྱིས
དབྱིགཉེན	དབྱིག་གཉེན
དབྱིགི་བླཽསཾ	དབྱིག་གི་བློ་གྲོས་མ
དབྱིགི་བླཽས	དབྱིག་གི་བློ་གྲོས
དབྱིགེས	དབྱིག་བཤེས
དབྱིགི༹ནཾ	དབྱིག་འཛིན་མ
དབྱིུངག	དབྱིངས་ཕྱུག
དབྱིུཾག	དབྱིངས་ཕྱུག
དབྱིུངགཾ	དབྱིངས་ཕྱུག་མ
སྦིུགཾ	དབྱིངས་ཕྱུག
དབྱིངསུ	དབྱིངས་སུ
དབྱིབསྣི་	དབྱིབས་ནི་
དབྱུ་གུཅིག་པ	དབྱུ་གུ་གཅིག་པ
དབྱུགི༹ན	དབྱུག་འཛིན
དབྱེནྱི་སྦྱོར་བ	དབྱེན་གྱི་སྦྱོར་བ
དབྱཻརད	དབྱེར་མེད
དབྱེརེད	དབྱེར་མེད
དབྱེརེཾད	དབྱེར་མེད
དབྲབྱ	དབྲབ་བྱ
དཾན	དམ་ཅན
དམ༹ན	དམ་ཅན
དཾ་པའི་ཆོསྱི	དམ་པའི་ཆོས་ཀྱི
དཾའི	དམ་པའི
དཾའ	དམ་བཅའ
དྃསྒྲཌ་	དམ་བསྒྲགས་
དྃན	དམ་མིན
ད༹ཾག	དམ་ཚིག
ད༹ཾགི	དམ་ཚིག
དམི༹ག	དམ་ཚིག
དཾགི༹སུཾ	དམ་ཚིག་གསུམ
ད༹ཾས	དམ་རྫས
དམ༹ས	དམ་རྫས
དཾ	དམ
དམགི	དམག་གི
དམགིས་བཅོཾ	དམག་གིས་བཅོམ
དམགིས་འཇོཾས	དམག་གིས་འཇོམས
དམུང༌	དམག་དཔུང༌
དམོན	དམག་དཔོན
དམོ༹ཊ	དམག་ཚོགས
དོམ༹གས	དམག་ཚོགས
དམྲུག	དམག་འཁྲུག
དཾངསྲིད	དམངས་སྲིད
དམའབེབས	དམའ་འབེབས
དཾརསུར	དམར་གསུར
དམཱར	དམར་དམར
དམརག	དམར་ནག
དཾརོ	དམར་པོ
དམརོ	དམར་པོ
དམོར	དམར་པོ
དྃརོ་	དམར་བོ་
དྃརོརསྒྱུར	དམར་བོར་སྒྱུར
དམརེངས	དམར་རེངས
དཾརེར	དམར་སེར
དེྃར	དམར་སེར
དྃར	དམར
དམིལ	དམིགས་བསལ
དམིཌྃདེ	དམིགས་མེད
དམིུལ	དམིགས་ཡུལ
དམིཌ་	དམིགས་
དམོདོར་བ	དམོད་དོར་བ
རྨོད	དམོད
དམྱཾས	དམྱལ་ཁམས
དརི	དར་དིར
དརྥུལ	དར་ཕུལ
དར་ངྱས	དར་རྒྱས
དར་ངྱས	དར་རྒྱས
དརཤིངློང	དར་ཤིང་སློང
དརྐབས	དར་སྐབས
དརསྲིནསྱོ	དར་སྲིན་གསོ
དལྱད	དལ་བརྒྱད
དལྱོར	དལ་འབྱོར
དླྱོར	དལ་འབྱོར
དལྱོར	དལ་འབྱོར
དལེན	དལ་རྟེན
དུགོངསྙྃ	དུ་དགོངས་སྙམ
དིུག	དུ་ཞིག
དུགྲོ	དུ་འགྲོ
དུརྩ་	དུ་རྩ་
དུགསུུུུུུཾ	དུག་གསུམ་བདུད་ཀུན་མྱུར་དུ་བབྟུ་ནུས་སུ
དུགསུཾ	དུག་གསུམ
དུགསུམ	དུག་གསུམ
དུགྲད	དུག་སྲད
དུགྔ	དུག་ལྔ
དཱུང	དུང་དུང
དྲོུ	དུད་འགྲོ
དུདགྲོའོ་	དུད་འགྲོའོ་
དུནས	དུན་ལས
དུྃབུསུྃསུྃ	དུམ་བུ་གསུམ་གསུམ
དུྃབུཅིུསྃ་	དུམ་བུ་བཅུ་གཉིས་
དུྃ	དུམ
དུརྲོད	དུར་ཁྲོད
དོུད	དུར་ཁྲོད
དྲོུད	དུར་ཁྲོད
དྲོུརད	དུར་ཁྲོད
དུརོད	དུར་ཁྲོད
དུརས	དུར་ས
དུསྐུནྔོ་	དུས་ཀུན་སྔོ་
དུབྱིག	དུས་ཀྱི་དབྱིག
དུས་ཀྱིད	དུས་ཀྱི་དབྱིགས
དུསིཊ	དུས་ཀྱི་དབྱིགས
དུསྱི	དུས་ཀྱི
དུསུཾ	དུས་གསུམ
དུསུམ	དུས་གསུམ
བདུསུཾ	དུས་གསུམ
དུསྲུགྟུ	དུས་དྲུག་ཏུ
དུསཾ་ེཕོརཾ	དུས་མེ་ཕོར་རམ
དུསྲོལ	དུས་འབྲེལ
དུསཡུནི	དུས་ཡུན་ནི
དུསུ	དུས་སུ
དུསྙིཌ་	དུས་སྙིགས་
དོུད	དུས་ཆོད
དོུསད	དུས་ཆོད
དུབྱིད	དུས་དབྱིགས
དུསྱིགས	དུས་དབྱིགས
དུསོད	དུས་མཆོད
དུཾའ	དུས་མཐའ
དུསོ༹ད	དུས་ཚོད
དུསུ	དུས་སུ
དེདི་	དེ་ཉིད་
དེག	དེ་དག
དེགི	དེ་དག་གི
དེགིས	དེ་དག་གིས
དེགོང	དེ་དག
དེུས	དེ་དུས
དེོན	དེ་དོན
དེ་བཞིནེཊ	དེ་བཞིན་གཤེགས་པ
དེནིཊེ་པ	དེ་བཞིན་གཤེགས་པ
དེནིཊེ	དེ་བཞིན་གཤེགས
དེནིཌེ་	དེ་བཞིན་གཤེགས་
དེབཞིངེས	དེ་བཞིན་གཤེགས
དེ་བཞིནིད	དེ་བཞིན་ཉིད
དེནིདི	དེ་བཞིན་ཉིད
དེབཞིནདི	དེ་བཞིན་ཉིད
དེནིུ	དེ་བཞིན་དུ
དླེས	དེ་ལས
དེསྲིདུ	དེ་སྲིད་དུ
དླེདུ	དེ་སླད་དུ
དེངསྐབསའི	དེང་སྐབས་སའི
དེདཔོན	དེད་དཔོན
དཻར	དེབ་ཐེར
དེམེ	དེམ་པེ
དེའིར	དེའི་ཕྱིར
དོགོང	དོ་དགོང
དཽག	དོག་དོག
དོགོ	དོག་པོ
དོཌ་	དོགས་
དོཌ་	དོགས་
དོངེ༹	དོང་ཙེ
དོདསོ	དོད་པོས
དོུན	དོན་ཀུན
དོནྲུབ	དོན་གྲུབ
དོནྲུབ	དོན་གྲུབ
དྲོུབ	དོན་གྲུབ
དོནན	དོན་ཅན
དོནམ	དོན་དམ
དོཾན	དོན་དམ
དོནུ	དོན་དུ
དོནི་	དོན་ནི་
དོན༹ད་པ	དོན་མཛད་པ
དོ༹ན	དོན་ཚན
དོནྯབཚིག	དོན་ཟབ་ཚིག
དོནྱུར	དོན་འགྱུར
དནྲཽུདབ	དོན་ཡོད་གྲུབ
དོནྲོུབ	དོན་ཡོད་གྲུབ
དཽནད	དོན་ཡོད
དོནོད	དོན་ཡོད
དོནུའིར	དོན་སྒྲུབ་པའི་ཕྱིར
དོནི	དོན་སྤྱི
དོམཁྲིས	དོམ་མཁྲིས
དོརྟ	དོར་རྟ
དྭཌ་	དྭགས་
དྭཌ	དྭགས
དྭངལ	དྭངས་གསལ
དྭངསྙིག	དྭངས་སྙིག
དྲགྲོས	དྲག་ཁྲོས
དྲོགསུཾ	དྲག་པོ་གསུམ
དྲོག༹ལ	དྲག་པོ་རྩལ
དྲགོ	དྲག་པོ
དྲོག	དྲག་པོ
དྲག༹ལ	དྲག་རྩལ
དྲགུལ	དྲག་ཤུལ
དྲགོས	དྲག་ཤོས
དྲཌ	དྲགས
དྲངེས	དྲང་ངེས
དྲངོའོ་	དྲང་བོའོ་
དྲངརོ	དྲང་བོར
དྲངིཾན	དྲང་མིན
དྲངངི་	དྲང་ཞིང་
དྲངྲོང༌	དྲང་སྲོང༌
དྲངྲོང༌	དྲང་སྲོང༌
དྲོང	དྲང་སྲོང
དྲངོང	དྲང་སྲོང
དྲནེར	དྲན་ཉེར
དྲནསྲིས	དྲན་ནས་བྲིས
དྲལྕམ	དྲལ་ལྕམ
དྲིབ	དྲི་ཆབ
དྲིཀུ་བ	དྲི་དཀུ་བ
དྲིནོ	དྲི་བཞོན
དྲིསུངཐུལ	དྲི་བསུང་འཐུལ
དྲིཆཾནཁུངགིརྔུལྖུའིདྲིའིཁྱད	དྲི་མཆན་ཁུང་གི་རྔུལ་ཆུའི་དྲིའི་ཁྱད
དྲིདེ་ྃའྱོདེ	དྲི་མེད་འོད་བྱེད
དྲིདེ	དྲི་མེད
དྲིདེཾ	དྲི་མེད
དྲིེད	དྲི་མེད
དྲིནན	དྲིན་ཅན
དྲིནེ	དྲིན་ཆེན
དྲིེན	དྲིན་ཆེན
དྲིནོེ	དྲིན་མོ་ཆེ
དྲླིན	དྲིན་ལན
དྲིའིྃང	དྲིའི་མིང
དྲིལུསྱིལཁརསྱིལ	དྲིལ་བུ་གསིལ་མཁར་གསིལ
དྲིལུ	དྲིལ་བུ
དྲིལྒྲ	དྲིལ་སྒྲ
དྲུགི	དྲུག་གི
དྲུགྟུ	དྲུག་ཏུ
དྲུགས་བཅུའིར	དྲུག་ནས་བཅུའི་བར
དྲུགྃ་	དྲུག་མ་
དྲུངུ	དྲུང་དུ
དྲུངྡུ	དྲུང་དུ
དྲིུག	དྲུང་ཞིག
དྲུངིག	དྲུང་ཡིག
དྲིུག	དྲུང་ཡིག
དྲོདཾདེ་	དྲོད་མེད་
དྲོདཚད	དྲོད་ཚད
ནཟང	ན་བཟང
ནའི་	ན་བའི་
ནོ༹ད	ན་ཚོད
ནྯུགླསྐྱེསྟེ	ན་ཟུག་ལས་སྐྱེས་ཏེ
ནྯུག	ན་ཟུག
ནྲེ	ན་རེ
ནེ	ན་རེ
ནྲེ	ན་རེ
ནྶོ་	ན་སོ་
ནགི	ནག་གི
ནགིས	ནག་གིས
ནགན	ནག་ཅན
ནགོ	ནག་ནོག
ནགོ	ནག་པོ
ནོག	ནག་པོ
ནགོཾ	ནག་མོ
ནོགམ	ནག་མོ
ནགསེབ	ནགས་གསེབ
ནགསཾ	ནགས་མ
ནགསེཾ	ནགས་མེ
ནགས	ནགས་སུ
ནགསྟུག་པོ	ནགས་སྟུག་པོ
ནཌསྱེངརྩྭསྱེང	ནགས་གསེང་རྩྭ་གསེང
ནཌ་	ནགས་
ནངཁྲོལྥོ་	ནང་ཁྲོལ་ཕོ་
ནངསྱེསྐུལླ	ནང་གསེས་སྐུལ་ལ
ནངུ	ནང་དུ
ནངཚནོ	ནང་ཚན་ནོ
ནངློག	ནང་སློག
ནངར	ནངས་པར
ནདནྱིཛེཾ་	ནད་ཅན་གྱི་འཛེམ་
ནདྲག་པ	ནད་དྲག་པ
ནྟན	ནན་ཏན
ནབསོ	ནབས་སོ
ནམྲུ	ནམ་གྲུ
ནྲུཾ	ནམ་གྲུ
ནཾཁའོ༹ད	ནམ་མཁའ་མཛོད
ནཾཁའ་རྒྱལ༹ན	ནམ་མཁའ་རྒྱལ་མཚན
ནམཁའ	ནམ་མཁའ
ནཾཁའ	ནམ་མཁའ
ནཾའ	ནམ་མཁའ
ནཾཁ	ནམ་མཁའ
ནཾཁའི	ནམ་མཁའི
ནམཐོང	ནམ་མཐོང
ནཾཟླ	ནམ་ཟླ
ནཾ་ལངས	ནམ་ལངས
ནཾངས	ནམ་ལངས
ནླྃངས	ནམ་ལངས
ནྃ	ནམ
ནཾས	ནམས
ནཱར	ནར་ནར
ནལོ	ནལ་ནོལ
ནསྱང་	ནས་ཀྱང་
ནསྠུ	ནས་ཐུ
ནསྠོན	ནས་ཐོན
ནསྱས	ནས་བྱས
ནསཾཆན	ནས་མཆན
ནསྃཉེས	ནས་མཉེས
ནསཐུནར	ནས་མཐུན་པར
ནསཚུར	ནས་ཚུར
ནསྲོ	ནས་འགྲོ
ནསདེཌཀའ	ནས་འདེགས་དཀའ
ནིསྤྱིའིལེར	ནི་སྤྱིའི་ལེ་བར
ཉིནྲིབྲིབཁྱག	ནིན་སྲིབ་སྲིབ་འཁྱག
ནོུ	ནུ་བོ
ནོུཾ	ནུ་མོ
ནུབྱོགས	ནུབ་ཕྱོགས
ནོུགས	ནུབ་ཕྱོགས
ནོུཊ	ནུབ་ཕྱོགས
ནུབྱ	ནུབ་བྱ
ནུབྱང༌	ནུབ་བྱང
ནུབྃ་	ནུབ་མ་
ནཱུར	ནུར་ནུར
ཉུལླསྱངཏྱཾ་	ནུལ་ལ་གསང་གཏམ་
ནུས	ནུས
ནེའུསྱིང	ནེའུ་གསིང
ནེའྠོུགྯེར	ནེིའུ་ཐོག་ཟེར
ནོངསྤྱོད	ནོངས་སྤྱོད
ནོམྱག	ནོམ་ཉུག
ནོཾ	ནོམ
ནོུར	ནོར་བུ
ནོརུ	ནོར་བུ
ནོརུའི	ནོར་བུའི
ནོརི༹ན	ནོར་འཛིན
ནོརྒྱུན་མ	ནོར་རྒྱུན་མ
ནོརྩེན	ནོར་རྩེན
ནོརྫས	ནོར་རྫས
ནོརྲིཁཾན	ནོར་སྲི་མཁན
ནོརྲིད	ནོར་སྲིད
པྯྱ	པ་གཟུགས
པྒལ	པ་གལ
པསྱགྱུར	པ་གསག་འགྱུར
པྕནང	པ་ཅན་གནང
པྕན	པ་ཅན
པྖེ་	པ་ཆེ་
པྖེནེའི	པ་ཆེན་པོའི
པང	པ་དང
པདཀརཾ	པད་དཀར་མ
པདཀར	པད་དཀར
པྣས	པ་ནས
པྣི་	པ་ནི་
པདེའི་	པ་བདེ་བའི་
པྱ	པ་བྱ
པྃཉེནོྃ་	པ་མཉེན་མོ་
པེཾད	པ་མེད
པཚ་	པ་ཚ་
པྮན	པ་ཞན
སྮིག	པ་ཞིག
པྯསྱི་	པ་ཟས་ཀྱི་
པྱང	པ་འཕྱང
ཕླ	པ་ལ
པྶྟེ་	པ་སྟེ་
པྶྟོང	པ་སྟོང
པསྨན	པ་སྨན
པྲོདིགཾ	པ་སྲོད་ཅིག་གམ
པཌ་	པགས་
པཌའི	པགས་པའི
པཌ	པགས
པདཀཏྱི	པད་དཀར་གྱི
པདྃཀརོའི	པདྨ་དཀར་བོའི
པདྨ	པད་མ
པདྨསྶྤྲས	པདྨས་སྤྲས
པདྨོ	པད་མོ
པཎེ	པཎ་ཆེན
པཎེན	པཎ་ཆེན
པང	པའང
པའཾ	པའམ
པཱི	པའི
པརྠང	པར་ཐང
པརུ	པར་དུ
ཕྲིན	པར་ཕྱིན
སཔྃགྱུརར	པས་མ་འགྱུར་བར
པསྷོ་	པས་ལྷོ་
པཱི	པི་པི
པླིང༌	པི་ལིང༌
པུསོ	པུས་མོ
པོི	པོ་ཏི
པྣོི་	པོ་ནི་
ཕྱགྣ	པྱག་ན
པྲགི	པྲག་པྲིག
ཕཾའི	ཕ་མའི
ཕེསཾ	ཕ་མེས
ཕལོ	ཕ་རོལ
ཕལོྲ	ཕ་རོལ
ཕྲོལ	ཕ་རོལ
ཕལོགསུ	ཕ་ལོགས་སུ
ཕལོཊུ	ཕ་ལོགས་སུ
ཕགི་ལོ	ཕག་གི་ལོ
ཕངུ	ཕང་ཕུང
ཕངསུ	ཕངས་སུ
ཕནོད	ཕན་གནོད
ཕནོཊ	ཕན་ཐོགས
ཕནོབ	ཕན་ཐོབ
ཕནོ	ཕན་ནོ
ཕནུ	ཕན་ཕུན
ཕུ༹ན	ཕན་ཚུན
ཕུཚན	ཕན་ཚུན
ཕྱནོ	ཕན་ཡོན
ཕབའྡིེའོ་	ཕབ་པའི་སྡེའོ་
ཕཾ་པ	ཕམ་པ
ཕྲིན་ཾཏྱོའི	ཕར་ཕྱིན་མ་གཏོགས་པའི་
ཕུ༹ར	ཕར་ཚུར
ཕལེན	ཕལ་ཆེན
ཕལེར	ཕལ་ཆེར
ཕལོེ	ཕལ་མོ་ཆེ
ཕོུ	ཕུ་བོ
ཕུགསུ	ཕུགས་སུ
ཕུངར	ཕུང་པར
ཕུངོ༌	ཕུང་པོ
ཕོུང	ཕུང་པོ
ཕོུང	ཕུང་བོ
ཕུངྱེད	ཕུང་བྱེད
ཕོུུཾགས	ཕུན་གསུམ་ཚོགས
ཕུགས	ཕུན་ཚོགས
ཕོུ༹གས	ཕུན་ཚོགས
ཕོུ༹གས	ཕུན་ཚོགས
ཕོུག༹ས	ཕུན་ཚོགས
ཕོུཊ	ཕུན་ཚོགས
ཕུནོ༹ཌ	ཕུན་ཚོགས
ཕུནཚོཌ་	ཕུན་ཚོགས་
ཕུནོ༹ཊ	ཕུན་སུམ་ཚོགས
ཕུནོཾ༹ཊ	ཕུན་སུམ་ཚོགས
ཕུནུཾཚོཌ	ཕུན་སུམ་ཚོགས་
ཕཱུམ	ཕུམ་ཕུམ
ཕུའིགོན	ཕུའི་དགོན
ཕུརརྱས	ཕུར་ཕུར་བྱས
ཕུརཚུཌ	ཕུར་ཚུགས
ཕུལྟེ	ཕུལ་ཏེ
ཕུལྣསྙནེང	ཕུལ་ནས་སྙན་སེང
ཕྙོ	ཕོ་ཉ
ཕྱོག	ཕོ་ཕྱག
ཕྱོུག	ཕོ་ཕྱུག
ཕྲོང༌	ཕོ་བྲང༌
ཕཽག	ཕོ་རོག
ཕརོལ	ཕོ་རོལ
ཕྱོུད	ཕོ་རྒྱུད
ཕོགསྡེར	ཕོགས་སྡེར
ཕོཌ་	ཕོགས་
ཕོུང་	ཕོང་བོ་
པྱ་ཾ	ཕྱ་མ་
ཕྱ༹ན	ཕྱ་ཚན
ཕྱགཉིས	ཕྱག་གཉིས
ཕྱགཡས	ཕྱག་གཡས
ཕྱཾའ	ཕྱག་མདའ
ཕྱུཾད	ཕྱག་མདུད
ཕྱག༹ན	ཕྱག་མཚན
ཕྱོ༹ད	ཕྱག་མཛོད
ཕྱ༹གོལ	ཕྱག་ཚལ་ལོ
ཕྱོ༹ལ	ཕྱག་ཚལ་ལོ
ཕྱགལོ	ཕྱག་འཚལ་ལོ
ཕྱག༹ལ	ཕྱག་ཚལ
ཕྱ༹ལ	ཕྱག་ཚལ
ཕྱ༹ལོད	ཕྱག་འཚལ་བསྟོད
ཕྱ༹ལྟོད	ཕྱག་འཚལ་བསྟོད
ཕྱག༹ལོ	ཕྱག་འཚལ་ལོ
ཕྱ༹ལོ	ཕྱག་འཚལ་ལོ
ཕྱག༹ལ	ཕྱག་འཚལ
ཕྱ༹ལ	ཕྱག་འཚལ
ཕྱ་རྒྱོེན	ཕྱག་རྒྱ་ཆེན་པོ
ཕྱརྒྱེནོ	ཕྱག་རྒྱ་ཆེན་པོ
ཕྱགྱ	ཕྱག་རྒྱ
ཕྱརྒྱ	ཕྱག་རྒྱ
ཕྱགྶཻན	ཕྱག་སེན་སེན
ཕྱགྲོལཡུལྲོལཾང	ཕྱག་སྲོལ་ཡུལ་སྲོལ་མང
ཕྱཊཾ	ཕྱགས་མ
ཕྱདོ	ཕྱད་ཕྱོད
ཕྱམ༡	ཕྱམ་གཅིག
ཕྱམེ་བ	ཕྱམ་མེ་བ
ཕྱར་བ་གྲུདཊ	ཕྱར་བ་གྲུ་གདགས
ཕྱརའི་	ཕྱར་བའི་
ཕྱྲིོ	ཕྱི་དྲོ
ཕྱིང་སངསུཾ	ཕྱི་ནང་གསང་གསུམ
ཕྱིངསངསུཾ	ཕྱི་ནང་གསང་གསུམ
ཕྱིངསུཾ	ཕྱི་ནང་གསང་གསུམ
ཕྱིང་ཾསློག	ཕྱི་ནང་མ་སློག
ཕྱིང༌	ཕྱི་ནང༌
ཕྱིག	ཕྱི་ཕྱག
ཕྱིལོ	ཕྱི་རོལ
ཕྱིལོྲ	ཕྱི་རོལ
ཕྱྲོིལ	ཕྱི་རོལ
ཕྱིདོ	ཕྱི་སྣོད
ཕྱོིད	ཕྱི་སྣོད
ཕྱིནོག	ཕྱིན་ཅི་ལོག
ཕྱིནད	ཕྱིན་ཆད
ཕྱིནས	ཕྱིན་ནས
ཕྱིརུ	ཕྱིར་དུ
ཕྱིརཟློགིསོ་	ཕྱིར་བཟློག་གི་གསོ་
ཕྱིརིཾ་ལྡོགརནྱས	ཕྱིར་མི་ལྡོག་པར་གནས
ཕྱིརིཾ	ཕྱིར་མི
ཕྱིརོ	ཕྱིར་རོ
ཕྱིསུ	ཕྱིས་སུ
ཕྱིསྐྱེས	ཕྱིས་སྐྱེས
ཕྱུཌི་	ཕྱུགས་ཀྱི་
ཕྱུགསྱིས་ཕྱུག	ཕྱུགས་ཀྱིས་ཕྱུག
ཕྱུགསྐྱོང༌	ཕྱུགས་སྐྱོང༌
ཕྱུཌང	ཕྱུགས་དང
ཕྱེུར	ཕྱེ་ཕུར
ཕྱེདང	ཕྱེད་དང
ཕྱེདོལ	ཕྱེད་ཡོལ
ཕྱེདྻོལ	ཕྱེད་ཡོལ
ཕྱོགསྱི་མུ་ཁྱུད	ཕྱོགས་ཀྱི་མུ་ཁྱུད
ཕྱོགསུཾ	ཕྱོགས་གསུམ
ཕྱོཊན	ཕྱོགས་ཅན
ཕྱཽགས	ཕྱོགས་ཕྱོགས
ཕྱོུ	ཕྱོགས་བཅུ
ཕྱོལྷི་ལྱ༹ལྟོད	ཕྱོགས་བཅུའི་ལྷ་ལ་ཕྱག་འཚལ་བསྟོད
ཕྱོུའི་ལྷ་ལྱ་སྟོད	ཕྱོགས་བཅུའི་ལྷ་ལ་ཕྱག་འཚལ་བསྡོད
ཕྱོུའི	ཕྱོགས་བཅུའི
ཕྱོུར	ཕྱོགས་བཅུར
ཕྱོ༹སཾ	ཕྱོགས་མཚམས
ཕྱོུང	ཕྱོགས་ལྷུང
ཕྱོགསུ	ཕྱོགས་སུ
ཕྱོགསུ	ཕྱོགས་སུ,
ཕྱོགསྐྱེས	ཕྱོགས་སྐྱེས
ཕྱོངོ༌	ཕྱོགས་སྐྱོང༌
ཕྱོཊོང༌	ཕྱོགས་སྐྱོང༌
ཕྱོགསྐྱོང	ཕྱོགས་སྐྱོང
ཕྱཽང	ཕྱོགས་སྐྱོང
ཕྱོཊ	ཕྱོགས
ཕྱོཌ	ཕྱོགས
ཕྲོཾ	ཕྲ་མོ
ཕྲོ༹མ	ཕྲ་ཚོམ
ཕྲགདང	ཕྲག་གདང
ཕྲགོང	ཕྲག་གོང
ཕྲོག	ཕྲག་དོག
ཕྲདོག	ཕྲག་དོག
ཕྲགྱེདང	ཕྲག་ཕྱེད་དང
ཕྲགི	ཕྲག་ཕྲིག
ཕྲིས	ཕྲིན་ལས
ཕྲློུགསྐྱོནྕནྱིརློག	ཕྲུ་སློག་སྐྱོན་ཅན་ཕྱིར་སློག
ཕྲུཌ་	ཕྲུགས་
ཕྲཱུལ	ཕྲུལ་ཕྲུལ
བཏྱིང	བ་གཏིང
བྕན	བ་ཅན
བ་ྖ	བ་ཆ་
བང	བ་དང
བྱོཌ	བ་ཕྱོགས
བྱསྣས	བ་བྱས་ནས
བཾངརོ་	བ་མང་བོར་
བབྲུ	བ་འབྲུ
བརིཾ	བ་རིམ
བྴརོ་	བ་ཤར་རོ་
བྟེ	བ་སྟེ
བྲེལྱེད	བ་སྦྲེལ་བྱེད
བྲུལྱིནྲུལདྕིག	བ་སྲུལ་གྱིན་སྲུལད་ཅིག
བཀགནླདཀར	བཀག་གནད་ལ་བཀར
བཀདང་པོ	བཀད་དང་པོ
བཀ༹ལ	བཀའ་གཅལ
བཀའཉྱན	བཀའ་གཉན
བཀྲིནེ	བཀའ་དྲིན་ཆེ
བཀྲིན	བཀའ་དྲིན
བཀའ་བརྒྱདཾས་པ	བཀའ་བརྒྱད་གདམས་པ
བཀྱད	བཀའ་བརྒྱད
བཀྱུད་པ	བཀའ་བརྒྱུད་པ
བཀྱུད	བཀའ་བརྒྱུད
བཀྱུར	བཀའ་བསྒྱུར
བཀ༹ལ	བཀའ་བསྩལ
བཀློན	བཀའ་བློན
བཀའགྱུར	བཀའ་འགྱུར
བཀྱུར	བཀའ་འགྱུར
བགྱུར	བཀའ་འགྱུར
བཀྡོད	བཀའ་སྡོད
བཀ༹ལ་པ	བཀའ་སྩལ་པ
བཀྲུང༌	བཀའ་སྲུང༌
བཀྲུང༌དཾན	བཀའ་སྲུང༌དམ་ཅན
བཀསད	བཀས་བཅད
བཀྲིསན	བཀྲ་ཤིས་ཅན
བཀྲིསྙི	བཀྲ་ཤིས་ཉི་མ
བཀྲིསྙི	བཀྲ་ཤིས་ཉི
བཀྲིས་བདཻཊ་ཐོབརཤོག	བཀྲ་ཤིས་བདེ་ལེགས་ཐོབ་པར་ཤོག
བཀྲིགོ	བཀྲ་ཤིས་ཤོག
བཀྲས	བཀྲ་ཤིས
བཀྲིས	བཀྲ་ཤིས
བཀྲྃ	བཀྲམ
བྖགས	བག་ཆགས
བགགས	བག་ཆགས
བགེ༹ར	བག་མཚེར
བགངས	བག་ཡངས
བགསྱིས	བགས་ཀྱིས
བགྲེང	བགྲོ་གླེང
བངེན	བང་ཆེན
བང༹དོ	བང་མཛོད
བངེན	བང་རྟེན
བཅགཞུཌ་	བཅག་བཞུགས་
བཅགྃལ	བཅག་མལ
བཅཌ་	བཅགས་
བཅཾ	བཅང
བཅཾསྯིན	བཅངས་ཟིན
ཅཾསྙིངཅུད	བཅངས་སྙིང་བཅུད
བཅདྖ	བཅད་ཁ
བཅདུྃ	བཅད་དུམ
བཅདའི	བཅད་པའི
བཅདར	བཅད་པར
བཅདྃཚསྃ	བཅད་མཚམས
བཅདྡན	བཅད་ལྡན
བཅདྡོག	བཅད་ལྡོག
བཅདྷག	བཅད་ལྷག
བཅདྴེས	བཅད་ཤེས
བཅདྶྐྱེ	བཅད་སྐྱེས
ཅྱད	བཅད
བཅབར	བཅབ་པར
བཅབྱ	བཅབ་བྱ
བཅསྱི	བཅས་ཀྱི
བཅསྟེ	བཅས་ཏེ
བཅབསྯིན	བཅབས་ཟིན
བཅྃསྯིན	བཅམས་ཟིན
བཅའྲིསྃ	བཅའ་ཁྲིམས
བཅརྃགི	བཅའ་མིག
བཅའྯྃ	བཅའ་ཟམ
བཅའགྲིག	བཅའ་འགྲིག
བཅའཕྲང	བཅའ་འཕྲང
བཅའྻང	བཅའ་ཡང
བཅའྻིག	བཅའ་ཡིག
བཅའླག	བཅའ་ལག
བཅའྲུང	བཅའ་སྲུང
བཅརླེབ	བཅར་ལེབ
བཅསྲིསྃ	བཅས་ཁྲིམས
བཅསའིསླབ	བཅས་པའི་བསླབ
བཅསའི	བཅས་པའི
བཅསར	བཅས་པར
བཅུསུ	བཅས་སུ
བཅིཾསཀྱིཌ་	བཅིངས་བཀྱིགས་
བཅིསཾཙིར	བཅིངས་བཙིར
བཅིསྲོཾལ	བཅིངས་འགྲོལ
བཅིཾས	བཅིངས
བཅིབྱ	བཅིབ་བྱ
ཅུཨིགིས	བཅུ་གཅིག་གིས
བཅིུགོ་	བཅུ་གཅིག་པོ་
བཅིུག	བཅུ་གཅིག
བཅིུག	བཅུ་གཅིག
བཅིུསྕད	བཅུ་གཉིས་བཅད
བཅིུསྃགི	བཅུ་གཉིས་མིག
བཅིུསུ	བཅུ་གཉིས་སུ
བཅིུས	བཅུ་གཉིས
བཅིུས	བཅུ་གཉིས
བཅུཾ	བཅུ་གསུམ
བཅུམ	བཅུ་གསུམ
བཅུསུཾ	བཅུ་གསུམ
བཅུུམ	བཅུ་གསུམ
བཅྖུའི	བཅུ་ཆའི
བཅུཔོན	བཅུ་དཔོན
བཅྲུགྖ	བཅུ་དྲུག་ཆ
བཅྲུག	བཅུ་དྲུག
བཅྲུག	བཅུ་དྲུག
བཅུག	བཅུ་དྲུག
བཅུནྡེ	བཅུ་བདུན་སྡེ
བཅུན	བཅུ་བདུན
བཅིུ	བཅུ་བཞི
བཅིུ་	བཅུ་བཞི་
བཅོུ	བཅུ་བོ
བཅྯུར	བཅུ་ཟུར
བཅུདྱིྃ་	བཅུད་ཀྱི་མ་
བཅུདྱི	བཅུད་ཀྱི
བཅུདྡྃནི	བཅུད་མི་ལྡན
བཅུདཛིན་	བཅུད་འཛིན་མ་
བཅིུ༹ན	བཅུད་འཛིན
བཅུདྡིང	བཅུད་རིང
བཅུདེན	བཅུད་ལེན
བཅེུན	བཅུད་ལེན
བཅུལྡན	བཅུད་ལྡན
བཅུྃ	བཅུམ
བཅུའིར	བཅུའི་བར
བཅེྃ	བཅེམ
བཅེསོ	བཅེས་སོ
བཅྱོདཐངྣས	བཅོ་བརྒྱད་ཐང་ནས
བཅྱོདར	བཅོ་བརྒྱད་བར
བཅྱོད	བཅོ་བརྒྱད
བཅྱོད	བཅོ་བརྒྱད
བཅྔོ	བཅོ་ལྔ
བཅྔོ	བཅོ་ལྔ
ནཅྔོའིདླབ	བཅོ་ལྔའི་ཟླ་བ
བཅོྃའི	བཅོམ་པའི
བཅློྃག	བཅོམ་བརླག
བཅྡོྃནསྱི	བཅོམ་ལྡན་འདས་ཀྱི
བཅྡོྃནསྃ	བཅོམ་ལྡན་འདས་མ
བཅྡོྃནས	བཅོམ་ལྡན་འདས
བཅྡོྃས	བཅོམ་ལྡན་འདས
བཅོནཾས	བཅོམ་ལྡན་འདས
བཅོནྡས	བཅོམ་ལྡན་འདས
བཅོཾདནས	བཅོམ་ལྡན་འདས
བཅོཾདས	བཅོམ་ལྡན་འདས
བཅོཾནས	བཅོམ་ལྡན་འདས
བཅོཾནྡས	བཅོམ་ལྡན་འདས
བཅྡོས	བཅོམ་ལྡན་འདས
བཅོནཾ	བཅོམ་ལྡན
བཅོཾདན	བཅོམ་ལྡན
བཅོཾན	བཅོམ་ལྡན
བཅྡོཾན	བཅོམ་ལྡན
བཅོྃ	བཅོམ
བཅོལདྃས	བཅོལ་གདམས
བཅོལྡྃ	བཅོལ་དམ
བཅོབྲིུརི༹ད	བཅོལ་པའི་ཕྱིན་ལས་འགྲུབ་üཨར་མཛོད
བཅོིུབརི༹དོ	བཅོལ་བའི་འཕྲིན་ལས་འགྲུབ་པར་མཛོད
བཅོལནིརི༹ད	བཅོལ་བའི་འཕྲིན་ལས་འགྲུབ་པར་མཛོད
བཅྲོིུབལོར༹དོ	བཅོལ་བའི་འཕྲིན་ལས་འགྲུབ་པར་མཛོད
བཅྲུབིརིཛོད་	བཅོལ་བའི་འཕྲིན་ལས་འགྲུབ་པར་མཛོད་
བཅོལའི	བཅོལ་བའི
བཅོལྃ	བཅོལ་མ
བཅོལོ	བཅོལ་ལོ
བཅོསའི	བཅོས་པའི
བཅོསྃ་	བཅོས་མ་
བཅོསུ་མེད	བཅོས་སུ་མེད
བཅོསྒྱུར	བཅོས་སྒྱུར
བཅོསྒྲིག	བཅོས་སྒྲིག
བཉཾས	བཉམས
བཏགསོ	བཏགས་སོ
བཏཌ	བཏགས
བཏངའི་	བཏང་བའི་
བཏངོཾས	བཏང་སྙོམས
བཏངྟེ	བཏང་སྟེ
བཏབྟེ	བཏབ་སྟེ
བཏུྃས	བཏུམས
བདགཞན་དོན༢	བདག་གཞན་དོན་གཉིས
བདགཞན	བདག་གཞན
བདགིནས	བདག་གི་གནས
བདགི	བདག་གི
བདགིས	བདག་གིས
བདགག	བདག་ཅག
བདགྕ	བདག་ཅག
བདགག	བདག་ཅག
བདགཌ	བདག་ཅགས
བདགིད	བདག་ཉིད
བདིད	བདག་ཉིད
བདགོ	བདག་པོ
བདགེད	བདག་མེད
བདགེཾད	བདག་མེད
བདགོཾ	བདག་མོ
བདགི༹ད	བདག་འཛིན
བདགི༹ན	བདག་འཛིན
བདུགོས	བདུག་སྤོས
བདུསོ	བདུག་སྤོས
བདོུས	བདུག་སྤོས
བདུདི	བདུད་ཉི
བདུདྙི	བདུད་ཉི
བདོུཾད	བདུད་མོ
བདུདལ	བདུད་འདུལ
བདུདུལ	བདུད་འདུལ
བདུད་དྱལ	བདུད་རྒྱལ
བདུདྱལ	བདུད་རྒྱལ
བདུདི༹	བདུད་རྩི
བདིུ༹ད	བདུད་རྩི
བདིུད༹	བདུད་རྩི
བདིུད	བདུད་རྩི
དུདི༹	བདུད་རྩི
བདིུ༹དའི	བདུད་རྩིའི
བདིུ༹དས	བདུད་རྩིས
བདེུན	བདུན་ཏེ
བདུནུ	བདུན་དུ
བདུནས	བདུན་ནས
བདུནོ་	བདུན་ནོ་
བདུནདྱ་	བདུན་བརྒྱ་
དུསུཾ	བདུས་གསུམ
བདུསུ	བདུས་སུ
བདཻགས	བདེ་གཤེགས
བདེགས	བདེ་གཤེགས
བདེགེས	བདེ་གཤེགས
བདེཊེ	བདེ་གཤེགས
བདེེགས	བདེ་གཤེགས
བདཻན	བདེ་ཆེན
བདེནེ	བདེ་ཆེན
བདེེན	བདེ་ཆེན
བདེགའ	བདེ་དགའ
བདེོན	བདེ་དོན
བདེའི	བདེ་བའི
བདེརེཌ་བའི	བདེ་བར་གཤེགས་བའི
བདེརེཊ	བདེ་བར་གཤེགས
བདེེརགས	བདེ་བར་གཤེགས
བདེར	བདེ་བར
བདེོཾག	བདེ་མཆོག
བེེེེེེེེེདན	བདེ་མེན་ཡེ་ཤས་ཆེ་སྐེ་གཏེར་དེ་དབེད
བདཻཊ	བདེ་ལེགས
ཅདཻཌ་	བདེ་ལེགས་
བདཻཌ་	བདེ་ལེགས་
བདེངོ༌	བདེ་སྐྱོང༌
བདྟཻར	བདེ་སྟེར
བདེནར	བདེན་པར
བདེ༹ནི	བདེན་འཛིན
བདེརེཊ	བདེར་གཤེགས
བདེརེཌ	བདེར་གཤེགས
བནེ	བན་དེ
བནུ	བན་བུན
བབསྟུན	བབ་བསྟུན
བོྃདྲུག	བམ་པོ་དྲུག
བོྃ	བམ་པོ
བཾ	བམ
བཙནྙི	བཙན་ཉི
བཙནྙིར	བཙན་ཉིར
བ༹ནོ	བཙན་པོ
བཙནོ	བཙན་པོ
བ༹ན	བཙན
བཙསྟོན	བཙས་སྟོན
བཙུཌ་	བཙུགས་
བཙུནོྃའོརི	བཙུན་མོའི་འཁོར
བཙུནོཾ	བཙུན་མོ
བཙུུུུུུུན	བཙུན་འཇུང་ཆུང་ཆུང་བུ་ཆུང་ཁུར
བཙོནང༌	བཙོན་ཁང༌
བཙོནུ	བཙོན་དུ
བཙོནཾ	བཙོན་མ
བཞགྣསཙེཾས་	བཞག་ནས་བཙེམས་
བཞགའི	བཞག་པའི
བཞདཀར	བཞད་དཀར
བཞཱད	བཞད་བཞད
༤ནུ	བཞིན་དུ
བཞིནུ	བཞིན་དུ
༤ནག	བཞིན་ནག
བཞིུམ༹	བཞིན་འཛུམ
༤ན	བཞིན
བཞུགསོུལ	བཞུགས་སུ་གསོལ
བཞུགསོ	བཞུགས་སོ
བཞུཊོ	བཞུགས་སོ
བཞུགསོ	བཞུགས་སོ
བཞུཌ་	བཞུགས་
བཞུཌ	བཞུགས
ཞེངསོ	བཞེངས་སོ
བཞེསོ	བཞེས་སོ
བཞེསུཨོལ	བཞེས་སུ་གསོལ
བཞེསུ	བཞེས་སུ,
བཟངན	བཟང་ངན
བཟངོ༌	བཟང་པོ
བཟངོ	བཟང་བོ
བཟངོཾ༌	བཟང་མོ
བཟྱོར	བཟང་སྦྱོར
བཟ༹ང	བཟའ་ཚང
བཟླའ	བཟའ་ཟླ
བཟའཚོ	བཟའ་འཚོ
བཟེུང༌	བཟེ་ཆུང༌
བཟོདཀའ་བ	བཟོད་དཀའ་བ
བཟོལྡན	བཟོད་ལྡན
བའྃགླིང	བའམ་གླིང
བའཾསློབཾང	བའམ་སློབ་མ་དང
བརད	བར་ཆད
བརད	བར་ཆད
བརྕོད	བར་ཆོད
བརོད	བར་ཆོད
བརུ	བར་དུ
བརེ	བར་བེར
བརཁ༹སཾ	བར་མཚམས
བརང༌	བར་སྣང༌
བརང	བར་སྣང
བརྐྱུཾང༌	བརྐྱང་བསྐུམ
བརྐྱུངམ	བརྐྱུང་བསྐྲུམ
བརྒལན	བརྒལ་ལན
བདྱང	བརྒྱ་དང
བརྒྱིན	བརྒྱ་བྱིན
བདྱརྩ	བརྒྱ་རྩ
བདྱ	བརྒྱ
བརྒྱནྱི	བརྒྱན་གྱི
བརྒྱནྱ	བརྒྱན་བྱ
བདྱབ	བརྒྱབ
བརྗོདའྡིེ་	བརྗོད་པའི་སྡེ་
བརྗོདའྡིེ་	བརྗོད་འི་སྡེ་
བརྔནྱ	བརྔན་བྱ
བརྔུབྱ	བརྔུབ་བྱ
བརྟགསོ	བརྟགས་སོ
བརྟནས	བརྟན་ནས
བརྟཱས	བརྟས་བརྟས
བརྟུག	བརྟུལ་ཞུགས
བརྟུགས	བརྟུལ་ཞུགས
བརྟུཊ	བརྟུལ་ཞུགས
བརྟུལུཌ་	བརྟུལ་བཞུགས་
བརྟེནས	བརྟེན་ནས
བརྡིང	བརྡ་རྙིང
བརྡྲོདབངོ༌	བརྡ་སྤྲོད་དབང་པོ
བརྡྲོད	བརྡ་སྤྲོད
བརྩནཁང	བརྩན་ཁང་
བརྩེསྃསེ	བརྩེ་སེམས
བརྩོུས	བརྩོན་འགྲུས
བརྩོནྲུས	བརྩོན་འགྲུས
བརྩོནྲུས	བརྩོན་འགྲུས
བྲྩོུས	བརྩོན་འགྲུས
བྲྩྲོུས	བརྩོན་འགྲུས
བརླབྱ	བརླབ་བྱ
བལསེདས	བལ་བསེད་འདས
བལྡན	བལ་ལྡན
གཏཾ	བལྟམས
ལྟཾ	བལྟམས
བལྟསྟེ	བལྟས་ཏེ
བལྡབྱ	བལྡབ་བྱ
བཤཌ་	བཤགས་
བཤཌ	བཤགས
བཤངལཾ	བཤང་ལམ
བཤདང༌	བཤད་དང༌
བཤྲུབ	བཤད་སྒྲུབ
བཤྲུབ	བཤད་སྒྲུབ
བཤདྶྒྲུབ	བཤད་སྒྲུབ
བཤྣཾས	བཤམས་ནས
བཤཾས	བཤམས
བཤའེ༹	བཤའ་ཚེ
བཤུལཾ	བཤུལ་ལམ
བཤེགསོ	བཤེགས་སོ
བཤེཌ	བཤེགས
བཤཻན	བཤེས་གཉེན
བཤེནེ	བཤེས་གཉེན
བཤེསེན	བཤེས་གཉེན
བཤྱེན	བཤེས་གཉེན
བཤྱཻན	བཤེས་གཉེན
བཤོའིདསྐུལ	བཤོའི་འདས་སྐུལ
བཤོལྡན	བཤོལ་ལྡན
བཤོསུ	བཤོས་བུ
བཤོསྲངས	བཤོས་དྲངས
བཤོསུཤེསྖུང	བཤོས་བུ་བཤོས་ཆུང
བཾའ	བས་མཐའ
བསོ་	བས་སོ་
བསགྱུར	བསག་འགྱུར
བསཌནསྔོ་	བསགས་ནས་བསྔོ་
བསཊའི	བསགས་པའི
བསཌསྦྱང	བསགས་སྦྱང
བསྃདུགཏོང	བསང་བདུག་གཏོང
བསྃཆོཾད	བསང་མཆོད
བསྃབུཾསང	བསང་འབུམ་བསང
བསྃཤུགསངརྫས	བསང་ཤུག་བསང་རྫས
བསངྣསཉེསེལ	བསངས་ནས་ཉེས་སེལ
བསདྯིན	བསད་ཟིན
བསདརྨས	བསད་རྨས
བསབགོས	བསབ་དགོས
བསབརྱསབྣས	བསབ་པར་བྱ་བསབས་ནས
བསྟཾནྱི་	བསམ་གཏན་གྱི་
བསཾན	བསམ་གཏན
བསྟཾན	བསམ་གཏན
བསྟཾན	བསམ་གཏན
བསྡཾན	བསམ་གཏན
བསཾཞྱི་	བསམ་གཞིག་
བསྟཾནྱི་	བསམ་གཡན་གྱི་
བསམྱིསིཾཁྱབསམིཁྱབསྡུས	བསམ་གྱིས་མི་ཁྱབ་བསམ་མི་ཁྱབ་བསྡུས
བསཾངན	བསམ་ངན
བསའི་	བསམ་པའི་
བསཾའིཁྱེརསོཉྲ	བསམ་པའི་འཁྱེར་སོ་གསུམ
བསྱོཾཌ	བསམ་ཕྱོགས
བསཾཞིནུ	བསམ་བཞིན་དུ
བསཾརྗོད་	བསམ་བརྗོད་
བསཾསེའུའིསྱང	བསམ་བསེའུའི་གསང
བསེཾའུ	བསམ་བསེའུ
བསྱུཾངི་	བསམ་བྱུང་གི་
བསྱུཾང	བསམ་བྱུང
བསློཾ	བསམ་བློ་
བསམནོ་	བསམ་མནོ་
བསཾཚུལེཌངི	བསམ་ཚུལ་ལེགས་ཤིང
བསཾཆརགོསྡུར	བསམ་འཆར་གོ་བསྡུར
བསཾཆརྡུ	བསམ་འཆར་བསྡུ
བསཾཕེལདབངི་	བསམ་འཕེལ་དབང་གི་
བསྱཾསཙུགླགཁང	བསམ་ཡས་གཙུག་ལག་ཁང
བསྱཾསཀརྖག	བསམ་ཡས་དཀར་ཆག
བསྱཾསཾཆིཾསུ	བསམ་ཡས་མཆིམས་ཕུ
བསཾས	བསམ་ཡས
བསྱཾས	བསམ་ཡས
བསྱུཾལསདས	བསམ་ཡུལ་ལས་འདས
བསྴེཾསྱུང	བསམ་ཤེས་བྱུང
བསེཾས	བསམ་ཤེས
བསྦྱོཾར	བསམ་སྦྱོར
བསྃ	བསམ
བསརྣས	བསར་ནས
བསརྒྱུ	བསར་རྒྱུ
བསལྱེགསྒྲུབྲྗོད	བསལ་བྱ་ལོག་སྒྲུབ་རྗོད
བསལཚཌ	བསལ་ཚགས
བསལྱུ	བསལ་རྒྱུ
བསིགསིཌ	བསིག་བསིགས
བསིངཁུ	བསིང་ཁུ
བསིངསྙིཌ	བསིང་སྙིགས
བསིངྣས	བསིངས་ནས
བསིལཁང	བསིལ་ཁང
བསིལདུཌ	བསིལ་གདུགས
བསིལཡབརླུངཡྱབསིལྲིགྃས	བསིལ་གཡབ་རླུང་གཡབ་བསིལ་རི་གངས
བསྱིབ	བསིལ་གཡབ
བསིལྲིབསིལྗོངསིལྡན	བསིལ་གྲིབ་བསིལ་ལྗོངས་བསིལ་ལྡན
བསིལའིཚལ	བསིལ་བའི་ཚལ
བསིལུ	བསིལ་བུ
བསིལྯེརྕན	བསིལ་ཟེར་ཅན
བསིལགུཌསིལྨན	བསིལ་འགུགས་བསིལ་སྨན
བསིལརིཌལྲང	བསིལ་རིགས་ལ་གྲང
བསིལྗོངས	བསིལ་ལྗོངས
བསིལྡན	བསིལ་ལྡན
བསིལྐཾ་	བསིལ་སྐམ་
བསིལྦྱིནཾཁནྟེ	བསིལ་སྦྱིན་མཁན་ཏེ
བསུསྨནཤངལཾཡརཏྱོང	བསུ་སྨན་བཤང་ལམ་ཡར་གཏོང
བསུགཾཉྲེཕུར	བསུག་མཉེར་ཕུར
བསུངཞིཾསུངད	བསུང་ཞིམ་བསུང་ངད
བསུྃསྲུལསུནས	བསུངས་རུལ་བསུན་ནས
བསུབྱུའང	བསུབ་རྒྱུའང
བསུབྣསདེཾར	བསུབས་ནས་མེད་པར
བསུཾ	བསུམ
བསིུསྣབཞགོ་	བསུམས་ནས་བཞག་གོ་
བསེོའྃ	བསེ་བོའང
བསྱེབསཁྲེབྕན	བསེ་ཡབ་བསེ་ཁྲབ་ཅན
བསྲེུ་	བསེ་རུ་
བསྲོུཀརོ	བསེ་རུ་དཀར་བོ
བསྲེུ	བསེ་རུ
བསྴེིང	བསེ་ཤིང
བསྦེུར	བསེ་སྦུར
བསེཌའི	བསེགས་པའི
བསེཌ	བསེགས
བསེངསྃསྲཟེར	བསེང་སངས་འདྲ་ཟེར
བསེནཉེནེསྙིང	བསེན་གཉེན་བཤེས་རྙིང
བསེནོཾདོན	བསེན་མོ་གདོན
བསོཾདས་ཕོུཊའི	བསོད་ནམས་ཕུན་ཚོགས་པའི
བསོདནཾས་ཕྲོུགས་པའི་བཀྲིགོ	བསོད་ནམས་ཕུན་སུམ་ཙཤོགས་པའི་བཀྲ་ཤིས་ཤོག
བསོད་ནཾས	བསོད་ནམས
བསོདཾས	བསོད་ནམས
བསོཾདས	བསོད་ནམས
བསོཾས	བསོད་ནམས
བསོདཾ	བསོད་ནམས
བསྙཽདྃས	བསོད་སྙོམས
བསྙོཾདས	བསོད་སྙོམས
བསྙོཾདས	བསོད་སྙོམས
བསྐངོ	བསྐང་ངོ
བསྐལོན	བསྐལ་དོན
བསྐལང༌	བསྐལ་བཟང༌
བསྐུལྱ	བསྐུལ་བྱ
བསྐུལཚིག	བསྐུལ་ཚིག
བསྐུལོ	བསྐུལ་ལོ
བསྐོརཾཕངས	བསྐོར་རམ་འཕངས
བསྐོསྟེ	བསྐོས་ཏེ
བསྐྱིཡྱར	བསྐྱི་གཡར
བསྐྱིའི	བསྐྱིའི
བསྐྱུངསྟེ	བསྐྱུངས་ཏེ
བསྐྱེདར	བསྐྱེད་པར
བསྐྱེེེད	བསྐྱེད་བསྐྱེད་བསྐྱེད
བསྐྱེེད	བསྐྱེད་བསྐྱེད
བསྐྱེ༹ཊོ	བསྐྱེད་རྫོགས
བསྐྱེད༹ཊོ	བསྐྱེད་རྫོགས
བསྐྱོེགས	བསྐྱེད་རྫོགས
བསྐྱོེདགས	བསྐྱེད་རྫོགས
བསྒབྱ	བསྒབ་བྱ
བསྒོཾ	བསྒོམ
བངྱུར་བ	བསྒྱུར་བ
བངྱུར་བ	བསྒྱུར་བ
བསྒྲུབྱ	བསྒྲུབ་བྱ
བསྒྲིཌ་	བསྒྲིགས་
བསྒྲིཌ	བསྒྲིགས
བསྔཌ	བསྔགས
བསྔལོ	བསྔལ་ལོ
བསྔཽན	བསྔོ་སྨོན
བསྙབྱ	བསྙབ་བྱ
བསྙེནས	བསྙེན་གནས
བསྙུར	བསྙེན་བཀུར
བསྙེུན	བསྙེན་བཀུར
བསྙེུར	བསྙེན་བཀུར
སྙེནྲུབ	བསྙེན་སྒྲུབ
སྙེཾས	བསྙེམས
བསྟནས	བསྟན་ནས
བསྟནོ	བསྟན་ནོ
བསྟནའི	བསྟན་པའི
བསྟནོས	བསྟན་བཅོས
བསྟོནས	བསྟན་བཅོས
བསྟོས	བསྟན་བཅོས
བསྟུནངས	བསྟན་བསྲུང
བསྟྲུང	བསྟན་བསྲུང
བསྟྲུནངས	བསྟན་བསྲུངས
བསྟྱུར	བསྟན་འགྱུར
བསྟནྱུར	བསྟན་འགྱུར
བསྟཛིན	བསྟན་འཛིན
བསྟ༹ནི	བསྟན་འཛིན
བསྟི༹ན	བསྟན་འཛིན
བི༹ན	བསྟན་འཛིན
བི༹ནི	བསྟན་འཛིན
སྟི༹ན	བསྟན་འཛིན,
བསྟནྱོང༌	བསྟན་སྐྱོང༌
བསྟོནང༌	བསྟན་སྐྱོང༌
བསྟོནང	བསྟན་སྐྱོང
བསྟྲུནཾ	བསྟན་སྲུང
བསྟོདོ	བསྟོད་དོ
བསྟོནས	བསྟོན་ནས
བསྡིུ༹བད	བསྡིགས་མཛུབ་མཛད
བསྡིུ༹བ	བསྡིགས་མཛུབ
བསྡིུ༹བ	བསྡིགས་འཛུབ
བསྡིུ༹བམད	བསྡུགས་མཛུབ་མཛད
བསྡུསཾངེ	བསྡུས་མིང
བསྡོཌ	བསྡོགས
བསྣོ༹གས	བསྣ་ཚོགས
བསྣཾས	བསྣམས
སྣཾས	བསྣམས
བསྣུབྱ	བསྣུབ་བྱ
བསྲོུངར	བསྲུང་འཁོར
བསྲོུར	བསྲུང་འཁོར
བསྲུབྱ	བསྲུབ་བྱ
བསྲུབསྐྱེས	བསྲུབས་སྐྱེས
སྲེགསྲེག	བསྲེག་བསྲེག
བསྲེག༹ས	བསྲེག་རྫས
བརླགྱུརཾ	བསླག་འགྱུར་རམ
སླབསུཾ	བསླབ་གསུམ
བསླབྡོཾ་	བསླབ་སྡོམ་
བསླབྱ	བསླབ་བྱ
བསླབྱིན	བསླབ་བྱིན
བསླབྱང	བསླབ་སྦྱང
བསླུའི	བསླུ་བའི
བསླེུད	བསླུ་མེད
བསླེུདཾ	བསླུ་མེད
བྚི	བི་ཊི
བུཅིུསྃ་	བུ་བཅུ་གཉིས་སམ་
བུཅོལ་ཁང	བུ་བཅོལ་ཁང
བེུདཾ	བུ་མེད
བུམོ	བུ་མོ
བོུ	བུ་མོ
བོུཾ	བུ་མོ
བུ༹	བུ་ཚ
བུ༹	བུ་ཚ
བོུན	བུ་ལོན
བེུ་	བུ་སྟེ་
བུགཉིས	བུག་གཉིས
བུགྤ	བུག་པ
བུདེཾ	བུད་མེད
བེུད	བུད་མེད
བིུང༌	བུད་ཤིང༌
བུཾ་པ	བུམ་པ
བུཾན	བུམ་མཁན
བུམགོ	བུམ་མགོ
བུཾ་སྟོང༌	བུམ་སྟོང༌
བུལྟོགདྲེསའི	བུལ་ཏོག་འདྲེས་པའི
བེོན	བེ་ཅོན
བེགེའང	བེག་གེའང
བོདྷིསཏྭས	བོ་དྷི་སཏྭས
བོུང༌	བོང་བུ
བོདྱི	བོད་ཀྱི
བོདང	བོད་དང
བོདུ	བོད་དུ
བོདིཾས	བོད་མིས
བོདྱིགསརྐྲུན	བོད་ཡིག་གསར་སྐྲུན
བོནྱི་	བོན་གྱི་
བོནིད	བོན་ཉིད
བོཉིད	བོན་ཉིད
བོོོོོོོན	བོན་པོ་སྔོན་པོ་གོས་སྔོན་པོ
བཽན	བོན་པོ
བོནོ	བོན་པོ
བོནྶོན	བོན་སོན
བོཾ་ཆོག	བོམ་ཆོག,
བྱུཾ	བྱ་ཁྱུང
བྱདཀའི་	བྱ་དཀའི་
བྱཏང་བ	བྱ་བཏང་བ
བྱལ་མ	བྱ་བལ་མ
བྱའེུ	བྱ་བྱེའུ
བྱོ༹གས	བྱ་ཚོགས
བྱརོག	བྱ་རོག
བྱོག	བྱ་རོག
བྱྲོག	བྱ་རོག
བྱང་ཆུབསྡཾའ	བྱང་ཆུབ་སེམས་དཔའ
བྱུངབ་སེཾདའ	བྱང་ཆུབ་སེམས་དཔའ
བྱུངེཾའ	བྱང་ཆུབ་སེམས་དཔའ
བྱུབཾ་སེཾའ	བྱང་ཆུབ་སེམས་དཔའ
བྱངུབ	བྱང་ཆུབ
བྱུངབ	བྱང་ཆུབ
བྱུབ	བྱང་ཆུབ
བྱུཾང༌	བྱང་ཆུབ
བྱུཾབ	བྱང་ཆུབ
བྱངེན	བྱང་ཆེན
བྱངུ༌	བྱང་དུ
བྱངྣས	བྱང་ནས
བྱོགས	བྱང་ཕྱོགས
བྱོངགས	བྱང་ཕྱོགས
བྱངྃ་	བྱང་མ་
བྱངགྲོད	བྱང་འགྲོད
བྱངར	བྱང་ཤར
བྱངསེཾར	བྱང་སེམས་དཀར
བྱངེཾས	བྱང་སེམས
བྱངསེསྃ	བྱང་སེམས
བྱངསྣེའིར	བྱང་སྣེའི་བར
བྱདབྱིབས	བྱད་དབྱིབས
བྱཾསེན	བྱམས་ཆེན
བྱཾས	བྱམས
བྱའིཤིང	བྱའི་ཤིང
བྱརྃདེེབྱིེྃ	བྱར་མེད་དེ་མི་དབྱེ
བྱསྱརཚེས	བྱས་གསར་ཚེས་དེར
བྱསྟེ་	བྱས་ཏེ་
བྱསའི	བྱས་པའི
བྱསར	བྱས་པར
བྱསོ	བྱས་སོ
བྱིནི	བྱི་བཞིན
བྱིཞིན	བྱི་བཞིན
བྱིཟུང	བྱི་བཟུང
བྱླླིོངང	བྱི་ལོང་དང
བྱིན་གྱིས་བརླབ་ཏོུལ	བྱིན་གྱིས་བརླབ་ཏུ་གསོལ
བྱིནབླིསཏོུལ	བྱིན་གྱིས་བརླབ་ཏུ་གསོལ
བྱིནླིབས་ཏོུལ	བྱིན་གྱིས་རླབས་ཏུ་གསོལ
བྱིནབླིས	བྱིན་གྱིས་རླབས
བྱིནིབས	བྱིན་གྱིས་རླབས
བྱིནླིབས	བྱིན་གྱིས་རླབས
བྱིནྱིསློབས	བྱིན་གྱིས་རློབས
བྱིནྱིས	བྱིན་གྱིས
བྱིེན་ངོར	བྱིན་ཆེན་ངོ་མཚར
བྱིནོ	བྱིན་ནོ
བྱིནརླསྱི	བྱིན་རླབས་ཀྱི
བྱིནླབསྱིས	བྱིན་རླབས་ཀྱིས
བྱིནབས	བྱིན་རླབས
བྱིནབླས	བྱིན་རླབས
བྱིནབླས	བྱིན་རླབས
བྱིནླབས	བྱིན་རླབས
བྱིནླབས	བྱིན་རླབས
བྱིསནདསྱོར	བྱིས་ནད་གསོ་བར
བྱིསའི	བྱིས་པའི
བྱིསྲད	བྱིས་སྲད
བྱུཌ་	བྱུགས་
བྱུངའྡིེ་	བྱུང་བའི་སྡེ་
བྱུངའྡིེ	བྱུང་བའི་སྡེ
བྱུངང་	བྱུང་བྱུང་
བྱཱུལ	བྱུལ་བྱུལ
བྱེགདྱདངུལྯངསོཌ་	བྱེ་བྲག་བརྒྱད་དངུལ་ཟངས་སོགས་
བྱེག	བྱེ་བྲག
བྱྲེག	བྱེ་བྲག
བྲེག	བྱེ་བྲག
བྱེདིང༌	བྱེད་ཅིང༌
བྱེདའི	བྱེད་པའི
བྱེདར	བྱེད་པར
བྱེའུར་བ	བྱེའུ་འུར་བ
བྱེསོུང༌	བྱེས་སུ་སོང༌
བྱོནས	བྱོན་ནས
བྱཽང༌	བྱོལ་སོང༌
བྱོལོང༌	བྱོལ་སོང༌
བྱོང	བྱོལ་སོང
བྱོངགས	བྱོལ་སོང
བྱཽལང	བྱོལ་སོང
བྱོོང	བྱོལ་སོང
བྱོལསོང	བྱོལ་སོང
བྲགཟེར	བྲག་གཟེར
བྲགཡང	བྲག་གཡང
བྲགསེང	བྲག་གསེང
བྲྣག	བྲག་ནག
བྲངེ	བྲང་བྲེང
བྲངྲུསཾན	བྲང་རུས་མན
བྲནུ	བྲན་དུ
བྲནོ	བྲན་པོ
བྲནོཾ	བྲན་མོ
བྲབྱ	བྲབ་བྱ
བྲེ༹ཾ	བྲམ་ཟེ
བྲེམ	བྲམ་ཟེ
བྲེཾ	བྲམ་ཟེ
བྲཾ	བྲམ
བྲལྱི	བྲལ་གྱི
འབྲུས	བྲས་བུ
བྲིས་པར	བྲིས་པ་དང་པར་མ
བྲུབསུ	བྲུབས་སུ
བྲུཾ	བྲུམ
བྲེཌ་	བྲེགས་
བྲོ་ྦ	བྲོ་བ་
བྲཽར་བ	བྲོ་བོར་བ
བླེན	བླ་ཆེན
བླརྡོལ	བླ་བརྡོལ
བླཾདཾ་པ	བླ་མ་དང་དམ་པ
བླིདཾ	བླ་མ་དང་ཡི་དམ
བླ་སློབ	བླ་མ་དང་སློབ་པ
བླིདཾ	བླ་མ་ཡི་དམ
བླཾ་སངྱས་རིནོེ	བླ་མ་སངས་རྒྱས་རིན་པོ་ཆེ
བླཾ	བླ་མ
བླངས་ཾེབྱ་	བླངས་མི་བྱ་
བློཾད	བླ་མཆོད
བློ༹ཾ	བླ་མཚོ
བླཾའཾ	བླ་མའམ
བླཾའི	བླ་མའི
བླཾརི༹ན	བླ་མར་འཛིན
བླཾར	བླ་མར
བླཾས	བླ་མས
བླས	བླ་མས
བླེཾད་ཡུཾ	བླ་མེད་ཡུམ
བླེད	བླ་མེད
བླེདཾ	བླ་མེད
བླེཾད	བླ་མེད
བླུཌ	བླུགས
བླུནོ	བླུན་པོ
བློུན	བླུན་པོ
བླཽས	བློ་གྲོས
བློས	བློ་གྲོས
བློོས	བློ་གྲོས
བླཽས	བློ་གྲོས,
བློན	བློ་དམན
བློག	བློ་བག
བློཅོལ་བ	བློ་བཅོལ་བ
བློདེ་བ	བློ་བདེ་བ
བློབབ	བློ་བབ
བློང༌	བློ་བཟང༌
བློཟང	བློ་བཟང
བློབཟོ	བློ་བཟོ
བློརླུག་པ	བློ་བརླུག་པ
བློསྒྱུར	བློ་བསྒྱུར
བློུག	བློ་བུག
བློུར	བློ་བུར
བློུན	བློ་མཐུན
བློི༹ན	བློ་འཛིན
བློ༹ལ	བློ་རྩལ
བླཽང	བློང་བློང
བློེན	བློན་ཆེན
བློན་འབངས	བློན་པོ་དང་འབངས་འཁོར
བླཽན	བློན་པོ
བློབོན	བློབ་དཔོན
མཱ	མ་མ
མྲཽད	མ་མོ་སྲོད
མྲིག	མ་རིག
མུས	མ་ལུས
མུསླ	མ་ལུས
མླུས	མ་ལུས
མཁནོ	མཁན་པོ
མཁནུ	མཁན་བུ
མཁནོ	མཁན་མོ
ཁྃན	མཁན
མཁྲུབ	མཁའ་གྲུབ
མཁྱིངས	མཁའ་དབྱིངས
མྱིངས	མཁའ་དབྱིངས
མཁོར	མཁའ་ནོར
མཁའགྲོ	མཁའ་འགྲོ
མཁརོ	མཁའ་འགྲོ
མཁྲོ	མཁའ་འགྲོ
མཁྲོའ	མཁའ་འགྲོ
མྲོ	མཁའ་འགྲོ
མཁྲོའི	མཁའ་འགྲོའི
མཁལྡིང༌	མཁའ་ལྡིང༌
མཁྡིང	མཁའ་ལྡིང
མཁྱའོད	མཁའ་སྤྱོད
མཁྱོད	མཁའ་སྤྱོད
མྱོད	མཁའ་སྤྱོད
མཁའྱ྄ོད	མཁའ་སྤྱོད
མཁརྗེ	མཁར་རྗེ
མཁསྲུབ	མཁས་གྲུབ
མཁྲུབ	མཁས་གྲུབ
མྲུབ	མཁས་གྲུབ
མཁསའི་	མཁས་པའི་
མཁོུ༹ས	མཁུར་ཚོས
མྱེན་པ	མཁྱེན་པ
མཁྱེནའི	མཁྱེན་པའི
མཁྱེནེ	མཁྱེན་བརྩེ
མཁྱེེེན	མཁྱེན་མཁྱེན་མཁྱེན
མཁྱཻན	མཁྱེན་མཁྱེན
མྱེནབ	མཁྱེན་རབ
མྱེབ	མཁྱེན་རབ
མྱེན	མཁྱེན
མཁྲནོ	མཁྲན་པོ
མཁྲེཊ་པ	མཁྲེགས་པ
མཁྲེཊོ	མཁྲེགས་པོ
མགོ	མག་མོག
མགལྨེ	མགལ་མེ
མགོཉིས	མགོ་གཉིས
མགོཏད	མགོ་གཏད
མགོནོན	མགོ་གནོན
མགོཞུག	མགོ་གཞུག
མགོཟེར	མགོ་གཟེར
མགོཡོཊ	མགོ་གཡོགས
མགོསུཾ	མགོ་གསུམ
མགོུག་པ	མགོ་གུག་པ
མགྲོུང	མགོ་གྲུང
མྱཽགཟོས	མགོ་ཉོག་བཟོས
མགྙོེན	མགོ་བརྙེན
མགྙོནེ	མགོ་བསྙེན
མགྙོེན	མགོ་བསྙེན
མགྲོེན	མགོ་འདྲེན
མྱོ་	མགོ་
མྱོནཁངཾ་	མགོན་ཁང་ངམ་
མགཽན	མགོན་པོ
མགོནོ	མགོན་པོ
མགོོན	མགོན་པོ
མྱཽན	མགོན་པོ
མགྱཽགས	མགྱོགས་མགྱོགས
མགྲིནག	མགྲིན་ནག
མྲིན་པ	མགྲིན་པ
མྲིནཟང་	མགྲིན་བཟང་
མགྲིོན	མགྲིན་སྔོན
མྲིནོ	མགྲིན་སྔོན
མངོ༌	མང་ངོ༌
མངུ	མང་དུ
མངོ་	མང་བོ་
མངརོ	མང་བོར
མངགཞུག	མངག་གཞུག
མངུག	མངག་གཞུག
མངའབངས	མངའ་འབངས
མངའོག	མངའ་འོག
མངལུ	མངལ་དུ
མངོནྱུར	མངོན་གྱུར
མངོནར	མངོན་པར
མངོར	མངོན་པར
མངོནདོ	མངོན་བརྗོད
མངོུ༹ལ	མངོན་ཚུལ
མངོསེ	མངོན་ཤེས
མངོེས	མངོན་ཤེས
ནྱོྃཐོང	མངོན་སུམ་མཐོང
མངསུཾ	མངོན་སུམ
མངོནུམ	མངོན་སུམ
མངོསུཾ	མངོན་སུམ
མཆུང	མཆན་ཁུང
མཆནུ	མཆན་བུ
མྲེལ	མཆན་འགྲེལ
མཆིགུ	མཆི་གུ
མཆིནད	མཆིན་ནད
མཆིལྷམ	མཆིལ་ལྷམ
མཆིསྟེ	མཆིས་ཏེ
ཆྃསི	མཆིས
མཆྡཻར	མཆེ་སྡེར
ྃཆེད	མཆེད
ཆྱོྃགི	མཆོག་གི
མཆོགསུཾ	མཆོག་གསུམ
མཆོགི་ཡཻས	མཆོག་གི་ཡེ་ཤེས
མཆོགི	མཆོག་གི
མཆོགསུཾ	མཆོག་གསུམ
མཆོགོ	མཆོག་གོ
ཆྱོེན	མཆོག་ཆེན
ཆྱབྱངས	མཆོག་དབྱངས
མཆོགྲན	མཆོག་བྲན
མཆོཡིན	མཆོག་སྦྱིན
མཆྱོ	མཆོག
ཆྱོ	མཆོག
ཆྱ	མཆོག
མཆོིས	མཆོད་གཞིས
མཆོདོ	མཆོད་དོ
མཆོདར	མཆོད་པར
མཆྟཽད	མཆོད་བསྟོད
མཆྱོན	མཆོད་ཡོན
མཆོཏེན	མཆོད་རྟེན
མཆོེན	མཆོད་རྟེན
མཆྟོེན	མཆོད་རྟེན
ཆོྃདེན	མཆོད་རྟེན
མཆོདེན	མཆོད་རྟེན
མཆོད༹ས	མཆོད་རྫས
ཆྱཽད	མཆོད་སྟོད
མཆྟཽད	མཆོད་སྟོད
མྲོིན	མཆོད་སྤྲིན
ཆྱོིནད	མཆོད་སྦྱིན
མཆོདིན	མཆོད་སྦྱིན
མཆོདྱིན	མཆོད་སྦྱིན
མཆྱོིདན	མཆོད་སྦྱིན
མཆྱོིན	མཆོད་སྦྱིན
ཆྱོད	མཆོད
ཆོཾད	མཆོད
མཇལོ	མཇལོ
མུང	མཇུག་བྱང
མཇུགཾ	མཇུག་མ
མཉནྙེསྃཉན	མཉན་ཉེས་མཉན
མཉདོ	མཉན་ཡོད
མཉོད	མཉན་ཡོད
ྃཉནྻོད	མཉན་ཡོད
མཉྃཉྱེར	མཉམ་གཉེར
མཉཾདི	མཉམ་ཉིད
མཉམིད	མཉམ་ཉིད
མཉིཾད	མཉམ་ཉིད
མཉྃཀྲོལྃ་	མཉམ་དཀྲོལ་མ་
མཉྃང་	མཉམ་དང་
མཉུྃསྲསྃམཉུྃ	མཉམ་དུ་བསྲེས་སམ་མཉམ་དུ
མཉཾ་པ	མཉམ་པ
མཉྃའིཇུགུཚལ	མཉམ་པའི་འཇུག་ཚུལ
མཉྃའི	མཉམ་པའི
མཉཾརག	མཉམ་པར་བཞག
མཉྃརྃ་	མཉམ་པར་མ་
མཉྃར	མཉམ་པར
མཉོྃརཇོག	མཉམ་པོར་འཇོག
མཉོྃར	མཉམ་པོར
མཉཾརོ	མཉམ་པོར
མཉྃགོསྱིས	མཉམ་བགོས་ཀྱིས
མཉཾག	མཉམ་བཞག
མཉྃ	མཉམ་བཞག
མཉྃརཞགའི	མཉམ་བར་བཞག་པའི
མཉྃདེ	མཉམ་མེད
མཉྃགྲནྃཉྃགྲོ	མཉམ་འགྲན་མཉམ་འགྲོ
མཉྃགྲོཌཉྃ	མཉམ་འགྲོགས་མཉམ་རྒྱུག
མཉྃཐུང	མཉམ་འཐུང
མཉེྃབྲེལ	མཉམ་འབྲེལ
མཉྃཛོྃས	མཉམ་འཛོམས
མཉྃསེ	མཉམ་རྗེས
མཉྃ	མཉམ
མཉཾས	མཉམས
མཉེནོ	མཉེན་པོ
མཉེནོྃ	མཉེན་མོ
ྃཉནླྕུག	མཉེན་ལྕུག
མཉེརསརེད	མཉེས་པར་བྱེད
མཉེསཉོསཚོར	མཉེས་པོ་མཉེས་ཚོར
མཉེསྱས	མཉེས་བྱས
མཉྱེསྱདེ	མཉེས་བྱེད
མཉེསིངྃཉེས	མཉེས་ཤིང་མཉེས
མཐྲལ	མཐ་བྲལ
མཐོབ	མཐ་འཁོབ
མཐའན	མཐའ་ཅན
མཐགི་	མཐའ་དག་གི་
མཐྡགི	མཐའ་དག་གི
མཐའག	མཐའ་དག
མཐྡག	མཐའ་དག
མཐྲལ	མཐའ་བྲལ
མཐ༹ཾས	མཐའ་མཚམས
མཐེདཾ	མཐའ་མེད
མཐའོབ	མཐའ་འཁོབ
མཐོབ	མཐའ་འཁོབ
མཐྱཾས	མཐའ་འབྱམས
མྱཾས	མཐའ་འབྱམས
མཐའས	མཐའ་ཡས
མཐས	མཐའ་ཡས
མཐྱས	མཐའ་ཡས
མཐྱས	མཐའ་ཡས
མཐའེན	མཐའ་རྟེན
མཐའོར	མཐའ་སྐོར
མཐརྠུགདོརྱོ་	མཐར་ཐུག་དེར་འགྲོ་
མཐརུག	མཐར་ཐུག
མཐུརག	མཐར་ཐུག
མཐརིནས	མཐར་ཕྱིན་ནས
མཐརིན	མཐར་ཕྱིན
མཐིརན	མཐར་ཕྱིན
མཐྱིན	མཐར་ཕྱིན
མཐྱིན	མཐར་ཕྱིན
མཐྱེན	མཐར་མཁྱེན
མཐརྶོནོ	མཐར་སོན
མཐིངག	མཐིང་ནག
མཐིམསོ	མཐིམས་སོ
མཐེུན	མཐུ་ཆེན
མཐོུབ	མཐུ་ཐོབ
མཐུ༹ལ	མཐུ་རྩལ
མཐུ༹ས	མཐུ་རྫས
མཐོུབས་བདགོ	མཐུ་སྟོབས་བདག་པོ
མཐོུབས	མཐུ་སྟོབས
ཐུདུ་	མཐུན་དུ་
མཐྱོུགས	མཐུན་ཕྱོགས
མཐྱོུཊ	མཐུན་ཕྱོགས
མཐོུང༌	མཐུན་མོང༌
མཐུནཾཨོངས	མཐུན་མོངས
མཐེུན	མཐུན་རྐྱེན
མཐེུན	མཐུན་རྐྱེན
མཐུན༹ས	མཐུན་རྫས
མཐེོང༌	མཐེ་བོང༌
མཐོེང	མཐེ་བོང
མཐོིསུཾ	མཐོ་རིས་གསུམ
མཐོི	མཐོ་རིས
མཐོིས	མཐོ་རིས
མཐྲོིས	མཐོ་རིས
མཐོངཾ	མཐོང་ལམ
ཐོཾངསྲིདེ	མཐོང་སྲིད་དེ
མཐོནོ	མཐོན་པོ
མཐོལོ་བཤཊ	མཐོལ་ལོ་བཤགས
མཐོལོཊ	མཐོལ་ལོ་བཤགས
མདངསུཾ	མདངས་གསུམ
མདའཕེན་པ	མདའ་འཕེན་པ
མདའ༹ནི	མདའ་འཛིན
མདོུན	མདུན་ན་འདོན
མདུནསུས	མདུན་ནས་བསུས
མདུནཁྲིསུ	མདུན་འཁྲིས་སུ
མདེའུསིལྱུར	མདེའུ་བསིལ་མྱུར
མདོེནཆེནོ	མདོ་ཆེན་ཆེན་པོ
མདོེན་སྟོངིད	མདོ་ཆེན་སྟོང་ཉིད
མདོེན	མདོ་ཆེན
མདོབུས	མདོ་དབུས
མདོར་མ	མདོ་དར་མ
མདཽན	མདོ་དོན
མདྲོན་པ	མདོ་དྲན་པ
མོདེ	མདོ་སྡེ
མདོགི	མདོག་གི
མདོངསེལ	མདོངས་སེལ
མདོའྡིེ་	མདོའི་སྡེ་
མདོུས	མདོར་བསྡུས
མྔག	མན་ངག
མངཾག	མན་ངག
མནག	མན་ངག
མནངག	མན་ངག
མྔཾག	མན་ངག
མནདུ	མན་ཆད་དུ
མནད	མན་ཆད
མནད	མན་ཆད
མནུ	མན་དུ
མནུ	མན་མུན
མནྲེལ	མནའ་འབྲེལ
མནལཾ	མནལ་ལམ
མནལྟོས	མནལ་ལྟོས
མཾ	མམ
མཚིས	མཚན་གཉིས
མཚིད	མཚན་ཉིད
མི༹ད	མཚན་ཉིད
མཚཾནེད་པ	མཚན་མ་མེད་པ
ཚླེདཾཔ	མཚན་མ་མེད་པ
མ༹ནཾ	མཚན་མ
མཚནཾ	མཚན་མ
མཚཾན	མཚན་མཁན
མཚནོ	མཚན་མཚོན
མཚནོཾའི	མཚན་མོའི
མཚན༹ད	མཚན་ཚད
མཚནྯུྃ	མཚན་ཟུམ
མཚླཾན	མཚན་ལྡན་མ
མཚྡན	མཚན་ལྡན
མཚླན	མཚན་ལྡན
མཚནད	མཚན་ཤད
མ༹ན	མཚན
མཚམསྱི	མཚམས་ཀྱི
མཚཾད	མཚམས་ཆད
མཚཾཅད	མཚམས་བཅད
མཚྩམད	མཚམས་བཅད
མཚམད	མཚམས་བརྒྱད
མཚྱྃད	མཚམས་བརྒྱད
མཚཱམས	མཚམས་མཚམས
mtsheMd	མཚམས་མེད
མཚུཾས	མཚམས་ཞུས
མཚྮུཾས	མཚམས་ཞུས
འཚུམས	མཚམས་ཞུས
མཾ༹སུ	མཚམས་སུ
མཚཾསུུ	མཚམས་སུ
ཚམསུ	མཚམས་སུ
མཚྲུཾབ	མཚམས་སྒྲུབ
མཚྲུམབ	མཚམས་སྒྲུབ
མཚམསྤྲིན	མཚམས་སྤྲིན
མཚཾསྤྲིན	མཚམས་སྤྲིན
མཚཾསྱོར	མཚམས་སྦྱོར
མཚྱམསོར	མཚམས་སྦྱོར
མཚྱོཾར	མཚམས་སྦྱོར
མཚྱོམར	མཚམས་སྦྱོར
མ༹ཾས	མཚམས
མཚཾས	མཚམས
མཚློང༌	མཚོ་གླང༌
མཚློངི༌	མཚོ་གླིང༌
མཚློིང	མཚོ་གླིང
མཚོུང	མཚོ་བྱུང
མཚྱོལ	མཚོ་རྒྱལ
མཚྱོལ	མཚོ་རྒྱལ
མཚྱོསེ	མཚོ་སྐྱེས
མཚྱོེས	མཚོ་སྐྱེས
མོཚོ་སོཌ	མཚོ་སོགས
མ༹ནོ	མཚོན
མཛངསླུན	མཛངས་བླུན
མཛད་དོུལ	མཛད་དུ་གསོལ
མཛདོུལ	མཛད་དུ་གསོལ
མ༹དའི	མཛད་པའི
མྱ༹ང	མཛད་བྱང
མ༹ད	མཛད
མཛསྴེ	མཛའ་བཤེས
མཛའོ	མཛའ་བོ
མཛུན	མཛའ་མཐུན
མེ༹སའི	མཛེས་པའི
མེ༹སྡན	མཛེས་ལྡན
མེ༹སྡུག	མཛེས་སྡུག
མེ༹ས	མཛེས
མཛཽྃ	མཛོ་མོ
མཛྶོར	མཛོ་སར
མ༹དོཔོན	མཛོད་དཔོན
མ༹དོག	མཛོད་བདག
མོ༹དནི	མཛོད་འཛིན
མ༹དོིན	མཛོད་ལྡན
མ༹ལྡོན	མཛོད་ལྡན
མ༹དོ	མཛོད
མར་མེཛད	མར་མེ་མཛད
མེར༹ད	མར་མེ་མཛད
མརེ	མར་མེ
མེར	མར་མེ
མྱིབ	མི་ཁྱབ
ྃནྱིསའི	མི་གནས་པའི
ནྱིཾས	མི་གནས
མིཡྱོ་	མི་གཡོ་
མྖིགོ	མི་ཆོག
མིང	མི་དང
མིཁས	མི་མཁས
མིགོ	མི་མགོ
མིངོན་པ	མི་མངོན་པ
མིཆོག	མི་མཆོག
མིཇེད	མི་མཇེད
མིཉཾ་པ	མི་མཉམ་པ
མིཐུནཉི	མི་མཐུན་ཉི
མིཐུནྙི	མི་མཐུན་ཉི
མིཐུན	མི་མཐུན
མིུན	མི་མཐུན
མིུསཚོད	མི་ནུས་ཚོད
ྃབྱི	མི་བྱ
མྱིོདེ	མི་བྱེད་དོ
མྱིདེ	མི་བྱེད
མྱིའོ་	མི་བྱྰོ་
མིཁྲེགིྃསལ	མི་མཁྲེག་མི་གསལ
མངིའ	མི་མངའ
མིཉལཉྃནྱསྱིདརླུང	མི་མཉམ་མཉམ་གནས་ཀྱི་རླུང
མིཐུནརྟཌ	མི་མཐུན་བརྟགས
མིཐུནལ	མི་མཐུན་ལ
མིཐུན	མི་མཐུན
མིི	མི་མི
མྱིུར	མི་འགྱུར
མིྱུར	མི་འགྱུར
མྲི	མི་འདྲ
མི་འཕྲོདཉི	མི་འཕྲོད་ཉི
མི་འཕྲོདྙི	མི་འཕྲོད་ཉི
མི་འཕྲོདྙི	མི་འཕྲོད་ཉི
མྲིོདཉི	མི་འཕྲོད་ཉི
ྃརྙྱོབེས	མི་རྙོབ་སླེབས
ྃལིཌེ་	མི་ལེགས་
ྃལྕིོཌདེྃ	མི་ལྕོགས་མེད
མིསུ	མི་ལུས
མིསླུས	མི་ལུས
མིུས	མི་ལུས
མླིུས	མི་ལུས
ིྃསྦྱོར	མི་སྦྱོར
མིསློབ	མི་སློབ
མློྃབ	མི་སློབ
མིགཅིག	མིག་གཅིག
མིགཉིས	མིག་གཉིས
མིགདངས་པ	མིག་གདངས་པ
མིགཡེར	མིག་གཡེར
མིགསུཾ་པ	མིག་གསུམ་པ
མིགི	མིག་གི
དམིར	མིག་དམར
མིར	མིག་དམར
མྲིུལ	མིག་འཕྲུལ
མིངུགས	མིང་གཟུགས
མྱིང༌	མིང་བྱང༌
མིངྶྟེ	མིང་སྟེ
མྲིང	མིང་སྲིང
མིནཾ	མིན་ནམ
མིནོ	མིན་ནོ
མྱུད	མུ་ཁྱུད
མེུ	མུ་གེ
མེུའི་བསྐལ་པ	མུ་གེའི་བསྐལ་པ
མིུག	མུ་ཏིག
མེུད	མུ་མེད
མེུན	མུ་མེན
མེུགས	མུ་སྙེགས
མེུགས	མུ་སྟེགས
མེུཊ	མུ་སྟེགས
མྟེུགས	མུ་སྟེགས
མྟེུཊ	མུ་སྟེགས
མུགི	མུག་གི
མུནག	མུན་ནག
མྲེཌོ་	མེ་གྲོགས་
མེསུཾ	མེ་གསུམ
མེྟོགིས	མེ་ཏོག་གིས
མྟེོགྃར	མེ་ཏོག་དམར
མྟེོགསེརོ	མེ་ཏོག་སེར་བོ་
མྟེོགསྨུགྕོན	མེ་ཏོག་སྨུག་པོ་ཅན
མེགོ	མེ་ཏོག
མེཏོག	མེ་ཏོག
མྟེོག	མེ་ཏོག
མོེག	མེ་ཏོག
མྟོེག	མེ་ཏོག
མྟེགོ	མེ་ཏོག
མེྟོག	མེ་ཏོག
མེ༹	མེ་བཙའ
མེཁའ	མེ་མཁའ
མེགལ	མེ་མགལ
མེཆེད་པ	མེ་མཆེད་པ
མེཉམ་གསང	མེ་མཉམ་གསང
མེདག	མེ་མདག
མེདའ	མེ་མདའ
མེཚམས	མེ་མཚམས
མེུར	མེ་མུར
མེོ	མེ་མོ
མེ༹ས	མེ་རྫས
མེ་ལེ༹ན	མེ་ལ་ཚེ་ཅན
མླེསྐྱེས	མེ་ལས་སྐྱེས
མེངོ༌	མེ་ལོང༌
མླེོང༌	མེ་ལོང༌
མོེང	མེ་ལོང
མློེང	མེ་ལོང
མྱེངོ	མེ་ལོང
མེློང	མེ་ལོང
མཏེར	མེ་ལྟར
མྟེར	མེ་ལྟར
མྷེ	མེ་ལྷ
མེདོ	མེད་དོ
མེདར་གྱུརིག	མེད་པར་གྱུར་ཅིག
མེདར	མེད་པར
མཻར	མེར་མེར
མེལེ༹	མེལ་ཚེ
མེལེ	མེལ་ཚེ
མེས་དབོན	མེས་པོ་དང་ཚ་བོ
མོུས	མོ་གུས
མྲཽུག	མོ་གྲུས་དྲག་པོ
མོ༹ན	མོ་མཚན
མྱོུད	མོ་རྒྱུད
མོནྲུ	མོན་གྲུ
མོནྲེ	མོན་གྲེ
མོནྲེ	མོན་དྲེ
མྲོན	མོན་སྲན
མྲོུགོ	མོས་གུས་དྲག་པོ
མོུས	མོས་གུས
མོསྒོཾ	མོས་སྒོམ
མོསྤྱོད	མོས་སྤྱོད
མྱནེད	མྱ་ངན་མེད
མྱངན	མྱ་ངན
མྱན	མྱ་ངན
མྱཾན	མྱ་ངན
མྱགོ	མྱག་མྱོག
མཌ་	མྱགས་
མྱངན	མྱང་ངན
མྱཱུར	མྱུར་མྱུར
མྱོངར	མྱོང་བར
ཙགི	ཙག་ཙིག
ཙྡན	ཙན་དན
ཙཱབ	ཙབ་ཙབ
ཙབུ	ཙབ་ཙུབ
ཙཾ	ཙམ
ཙིཙི	ཙི་ཙི
ཙིཚེའབྲུ	ཙི་ཚེ་འབྲུ
ཙོགུ	ཙོག་པུ
ཚོཾས་ཁ་	ཚ་མོས་ཁ་
ཚཟེར	ཚ་ཟེར
ཚགསུ	ཚགས་སུ
ཚངི༹	ཚང་ཚིང
ཚངསར	ཚངས་པར
ཚཾསྲེད	ཚངས་ཕྱེད
ཚངསྐུལ	ཚངས་བསྐུལ
ཚངསྐུད	ཚངས་སྐུད
ཚངསྐྱེས	ཚངས་སྐྱེས
ཚངསྤྱོད	ཚངས་སྤྱོད
ཚངསྲས	ཚངས་སྲས
ཚདགུང	ཚད་དགུང
ཚདུས	ཚད་དུས
ཚདཾ	ཚད་མ
ཚྨད	ཚད་མ
ཚདཾརི༹ན	ཚད་མར་འཛིན
ཚདེཾ	ཚད་མེད
ཚྃདེད	ཚད་མེད
ཚདས	ཚད་ཡས
ཚཱན་རིག་པ	ཚན་ཚན་རིག་པ
ཚམོ༹	ཚམ་ཚོམ
ཚརུ	ཚར་བུ
ཚིགུྃང	ཚི་གུ་མང
ཚིགཉན	ཚིག་གཉན
ཚིགསུཾ	ཚིག་གསུམ
ཚིགསུཾ	ཚིག་གསུམ
ཚིགི	ཚིག་གི
ཚིགིས	ཚིག་གིས
ཚྙིགོ	ཚིག་ཉོག
བཅད་ལྷུག	ཚིག་བཅད་དང་ལྷུག་མ
ཚིགང་	ཚིག་རྐང་
ཚིགད	ཚིགས་བཅད
ཚིགསད	ཚིགས་བཅད
ཚིགསུད	ཚིགས་སུ་བཅད
ཚིགསུལ	ཚིགས་སུལ
ཚིཌ	ཚིགས
ཚུཌ	ཚུགས
ཚུནདུ	ཚུན་ཆད་དུ
ཚུལྲིྃསུྃ་	ཚུལ་ཁྲིམས་གསུམ་
ཚུལྲིམས	ཚུལ་ཁྲིམས
ཚིུམས	ཚུལ་ཁྲིམས
ཚིུལྲཾས	ཚུལ་ཁྲིམས
ཚུྲིུ༹ས	ཚུལ་ཁྲིམས
ཚྲུལིམ	ཚུལ་ཁྲིམས
ཚྲིུ༹ཾས	ཚུལ་ཁྲིམས
ཚུལུགས	ཚུལ་ལུགས
ཚུལུཊ	ཚུལ་ལུགས
ཚུལྡན	ཚུལ་ལྡན
ཚེ་བསོད	ཚེ་དང་བསོད་ནམས
ཚེདཔགེདཾ	ཚེ་དཔག་མེད
ཚེྡང	ཚེ་དབང
ཚེསོད	ཚེ་བསོད
ཚེད	ཚེ་ཚད
ཚེེ	ཚེ་ཚེ
ཚེདས	ཚེ་འདས
ཚྡེས	ཚེ་འདས
ཚེངི༌	ཚེ་རིང༌
ཚེིངྱོནརོག	ཚེ་རིང་ལོ་བརྒྱ་ལོན་པར་ཤོག
ཚེདན	ཚེ་ལྡན
ཚྡེན	ཚེ་ལྡན
ཚྲེགོ	ཚེ་སྲོག
ཚྲོེག	ཚེ་སྲོག
ཚེུཾ	ཚེམ་བུ
ཚེརཾ	ཚེར་མ
ཚེསྱི	ཚེས་ཀྱི
ཚེསའི	ཚེས་པའི
ཚོཊདག	ཚོགས་བདག
བསག་སྦྱང	ཚོགས་བསག་པ་དང་སྡིག་པ་སྦྱང་བ
ཚོགསྦྱོར	ཚོགས་སྦྱོར
ཚོགསུ	ཚོགས་སུ
ཚོཌ	ཚོགས
ཚོཌ	ཚོགས
ཚོནོ	ཚོན་པོ
ཚོནི༹	ཚོན་རྩི
ཚོུཾ	ཚོམ་བུ
ཚོཾས	ཚོམས
ཆོསྱི་	ཚོས་ཀྱི་
ཆྒོསོ	ཚོས་གོས་
ཚོསླ	ཚོས་སླ
ཛམྦུའྖིུསྱེར	ཛམྦུའི་ཆུ་གསེར
ཝན	ཝ་ཅན
ཝརྣཾསྱིསྨྲས་པ	ཝ་རྣམས་ཀྱིས་སྨྲས་པ
ཝལེ	ཝ་ལེ
ཝལེ	ཝལ་ལེ
ཞྙེ	ཞ་ཉེ
ཞགསུཾ	ཞག་གསུམ
ཞགསུཾ	ཞག་གསུམ
ཞགཕུལྱིྃདེ	ཞག་འཕུལ་མི་བྱེད
ཞཌ་	ཞགས་
ཞངུ	ཞང་ཞུང
ཞབསྱི	ཞབས་ཀྱི
ཞབསྱིས	ཞབས་ཀྱིས
ཞྱུ	ཞབས་ཀྱུ
ཞབསཾ	ཞབས་མ
ཞྲེན	ཞབས་འདྲེན
ཞྲིང	ཞབས་འབྲིང
ཞབསུ	ཞབས་སུ
ཞབསེན	ཞབས་སེན
ཞརོ	ཞར་ཞོར
ཞལ་གདཾས	ཞལ་གདམས
ཞལྱི་གདཾས་པ	ཞལ་གྱི་གདམས་པ
ཞལྱི	ཞལ་གྱི
ཞཾལས	ཞལ་ཟས
ཞལ༹ས	ཞལ་ཟས
ཞལས	ཞལ་ཟས
ཞ༹ས	ཞལ་ཟས
ཞལག	ཞལ་ལག
ཞལྔ	ཞལ་ལྔ
ཞལྕེ	ཞལ་ལྕེ
ཞལྔར	ཞལ་སྔར
ཞིོ	ཞི་ཁྲོ
ཞོི	ཞི་ཁྲོ
ཞིནྱསྱི	ཞི་གནས་ཀྱི
ཞིུལ	ཞི་དུལ
ཞྲིག	ཞི་དྲག
ཞིའི	ཞི་བའི
ཞིགིས	ཞིག་གིས
ཞིངཁཾསུ	ཞིང་ཁམས་སུ
ཞིངསུཾ	ཞིང་ཁམས་སུ
ཞིངམས	ཞིང་ཁམས
ཞིངསཾ	ཞིང་ཁམས
ཞིསཾ	ཞིང་ཁམས
ཞིངེཊ	ཞིང་གཤེགས
ཞིངེན	ཞིང་ཆེན
ཞིེངན	ཞིང་ཆེན
ཞིངྣས	ཞིང་ནས
ཞིངྦའོ་	ཞིང་བའོ་
ཞིངས	ཞིང་ལས
ཞྱིསེ	ཞིང་སྐྱེས
ཞིངྱོ༌	ཞིང་སྐྱོང༌
ཞྱོིང	ཞིང་སྐྱོང
ཞིབཤེར	ཞིབ་བཤེར
ཞིབཾཐོང	ཞིབ་མཐོང
ཞིབསོ	ཞིབས་སོ
ཞིྃ་	ཞིམ་
ཞོུལ	ཞུ་གསོལ
ཞེུན	ཞུ་ཆེན
ཞུར	ཞུ་བར
ཞུཾན	ཞུ་མཁན
ཞིུད	ཞུ་མཆིད
ཞིུང༌	ཞུ་ཞིང༌
ཞིུག	ཞུ་ཡིག
ཞུགསླ	ཞུགས་སླ
ཞུཌ་	ཞུགས་
ཞུནཾསྲིས	ཞུན་མས་བྲིས་
ཞུབན	ཞུབ་ཅན
ཞུབེན	ཞུབ་ཆེན
ཞུམེད	ཞུམ་མེད
ཞེུཾད	ཞུམ་མེད
ཞཱུམ	ཞུམ་ཞུམ
ཞུསོ	ཞུས་སོ
ཞེསུཾ	ཞེ་གསུམ
ཞྲེག	ཞེ་དྲག
ཞེུསོ	ཞེ་ཞུས་སོ
ཞྡེང༌	ཞེ་སྡང༌
ཞེསྡང	ཞེ་སྡང
ཞེནཊ	ཞེན་ཆགས
ཞེསུངའི་དོན	ཞེས་གསུང་བའི་དོན
ཞྱེངོས	ཞེས་གསུང་སོ
ཞེསུངས་པ	ཞེས་གསུངས་པ
ཞེུངསོ	ཞེས་གསུངས་སོ
ཞེསུངསོ	ཞེས་གསུངས་སོ
ཞེསཔོ་	ཞེས་པའོ་
ཞེསའོ	ཞེས་པའོ
ཞེསྗོད	ཞེས་བརྗོད་པ
ཞེསྟཽད	ཞེས་བསྟོད་དོ
ཞེསྟོདོ	ཞེས་བསྟོད་དོ
ཞེུསོ	ཞེས་ཞུས་སོ
ཞེསོ	ཞེས་སོ
ཞེསོཌ་	ཞེས་སོགས་
ཞྙོལ	ཞོ་སྙལ
ཞོདྖོ	ཞོད་ཆེ
ཟཁངྀ	ཟ་ཁང
ཟྱེད	ཟ་བྱེད
ཟྃ་	ཟ་མ་
ཟཞིང	ཟ་ཞིང
ཟགྕསྯགེགད	ཟག་བཅས་ཟག་མེད
ཟགེདཾ	ཟག་མེད
ཟགེཾད	ཟག་མེད
ཟགྃདེ	ཟག་མེད
ཟེད	ཟག་མེད
ཟངསཡྱའ	ཟངས་གཡའ
ཟངལྕཌ	ཟངས་ལྕགས
ཟདེ	ཟད་དེ
ཟདྱེད	ཟད་བྱེད
ཟབརླིང	ཟབ་བརླིང
ཟབོཾ	ཟབ་མོ
ཟབསུ	ཟབས་སུ
ཟམུ	ཟམ་ཟུམ
ཟྃ	ཟམ
ཟརུ	ཟར་ཟུར
ཟསཉྱ	ཟས་གཉག
ཟསང་	ཟས་དང་
ཟསྕུད	ཟས་བཅུད
ཟསོད	ཟས་བསོད
ཟསུ	ཟས་སུ
ཟཱིང	ཟིང་ཟིང
ཟིནདྱང	ཟིན་ཀྱང
ཟིནར	ཟིན་པར
ཟིུང༌	ཟིན་ཕུང༌
ཟཱིམ	ཟིམ་ཟིམ
ཟིལཾ	ཟིལ་མ
ཟུངིག	ཟུང་གཅིག
ཟུངུ༹ད	ཟུང་ཚུད
ཟུངག	ཟུང་འཇུག
ཟུངུག	ཟུང་འཇུག
ཟུུཾག	ཟུང་འཇུག
ཟུངྲེལ	ཟུང་འབྲེལ
ཟུངོར	ཟུང་སྦྱོར
ཟུངྱོར	ཟུང་སྦྱོར
ཟུཾ	ཟུམ
ཟེརྕན	ཟེར་ཅན
ཟེརངི	ཟེར་ཞིང
ཟེརོ	ཟེར་རོ
ཟྣོས	ཟོས་ནས
ཟླཾ་གསིུམས	ཟླ་གམ་གསུམ་གྱིས
ཟླཾན	ཟླ་གམ་ཅན
ཟླཾ	ཟླ་གམ
ཟློ	ཟླ་བོ
ཟླ༹ན	ཟླ་མཚན
ཟླེ༹སཾ	ཟླ་མཛེས་མ
ཟླེ༹ས	ཟླ་ཚེས
ཟླེར	ཟླ་ཟེར
ཟླི༹ན	ཟླ་འཛིན
ཟློུཾ	ཟླུམ་པོ
ཟླཱུམ	ཟླུམ་ཟླུམ
ཟློསྐྱོན	ཟློས་སྐྱོན
འཁརིལ	འཁར་གསིལ
འཁརྔ	འཁར་རྔ
འཁོི༹ན	འཁོན་འཛིན
འོན	འཁོན
འཁོབྃ	འཁོབ་བམ
འཁོབལ	འཁོབ་བལ
འརོི་	འཁོར་གྱི་
འཁོརངས	འཁོར་དང་བཅས
འརོངས	འཁོར་དང་བཅས
འྲོངས	འཁོར་དང་བཅས
འཁོར་འདས	འཁོར་བ་དང་མྱང་འདས
འརོའི	འཁོར་བའི
འཁོརས	འཁོར་བཅས
འཁོརས	འཁོར་བཅས
འརོས	འཁོར་བཅས
འྲོས	འཁོར་བཅས
༅ཁོརངས	འཁོར་བསྲུངས
འཁྲོུརངས	འཁོར་བསྲུངས
འརོུངས	འཁོར་བསྲུངས
འོརུངས	འཁོར་བསྲུངས
འྲུཨོརང	འཁོར་བསྲུངས
འྲོུགནས	འཁོར་བསྲུངས
འརོདསོ	འཁོར་འདས་སོ
འཁོརས	འཁོར་འདས
འཁོརྡས	འཁོར་འདས
འཁྡོརས	འཁོར་འདས
འཁྡོས	འཁོར་འདས
འརོ་ཡུགི	འཁོར་ཡུག་གི
འཁོརྒྱལ	འཁོར་རྒྱལ
འཁོརོ་སྡོཾ་པ	འཁོར་ལོ་སྡོམ་པ
འཁཽར	འཁོར་ལོ
འཁོརོ	འཁོར་ལོ
འཁོོར	འཁོར་ལོ
འོར	འཁོར་ལོ
འོརོ	འཁོར་ལོ
འརཽ	འཁོར་ལོ
འཽར	འཁོར་ལོ
འཁཽརར	འཁོར་ལོར
འརོ	འཁོར
འོར	འཁོར
འཁྱགོ	འཁྱག་འཁྱོག
འཁྱཾས	འཁྱམས
འཁྱརོ	འཁྱར་འཁྱོར
འཁྲིགྱོར	འཁྲིག་སྦྱོར
འཁྲིལྱོར	འཁྲིལ་སྦྱོར
འཁྲོུ༹ད	འཁྲུག་རྩོད
འཁྲུངོ༌	འཁྲུག་ལོང༌
འཁྲུངསྐར	འཁྲུངས་སྐར
འཁྲུཾསོ	འཁྲུངས་སོ
ཁྲུངསོ	འཁྲུངས་སོ,
འཁྲོུར	འཁྲུལ་འཁོར
འཁྲོུརོ	འཁྲུལ་འཁོར
འགགེཾད	འགག་མེད
འགེཾད	འགག་མེད
འགེམྡ	འགག་མེད
འགགཾཨེད	འགག་མེད
འགིག	འགའ་ཞིག
འགིགི	འགའ་ཞིག་གི
འགལྱེན་བརད	འགལ་རྐྱེན་བར་ཆད
འགལྱེན	འགལ་རྐྱེན
འགུཌ་	འགུགས་
འགུམསུ	འགུམས་སུ
འགཽ	འགོ་བོ
འགོང	འགོང་པོ
འགོངོ	འགོང་པོ
འགོངའི	འགོང་བའི
འགོདཀའོ་	འགོད་དཀའའོ་
འགོནོ	འགོན་པོ
གའོའ	འགོའ
འགྱརུ	འགྱར་འགྱུར
འགྱེུད	འགྱུ་བྱེད
འགྱུརེད	འགྱུར་མེད
འགྱུརེཾད	འགྱུར་མེད
འགྱུརོ	འགྱུར་རོ
འགྱོཌ	འགྱོགས
འགྲིཾས	འགྲིམས
འགྲུབྱ	འགྲུབ་བྱ
འགྲུབྱོར	འགྲུབ་སྦྱོར
འགྲོུར	འགྲུབ་སྦྱོར
འགྲཽཊ	འགྲོ་གྲོགས
འགྲཽན	འགྲོ་དོན
འགྲོུག	འགྲོ་དྲུག
འགྲོུག	འགྲོ་དྲུག
འགྲོ་སྡོད	འགྲོ་བ་དང་སྡད་པ
འགྲོན	འགྲོ་མགན
འགྲཽན	འགྲོ་མགོན
འགྲཽན	འགྲོ་མགོན
འགྲོགྱུརང	འགྲོ་འགྱུར་དང
འགྲོནུ	འགྲོན་བུ
འཆགསོ	འཆགས་སོ
འཆཊོ	འཆགས་སོ
འཆབྱེད	འཆབ་བྱེད
འཆལོ	འཆལ་ལོ
འཆིག	འཆི་བདག
འཆྡིག	འཆི་བདག
འཆི་མེདབང་མོ	འཆི་མེད་དབང་མོ
འཆིདེོཾ	འཆི་མེད་དབང་མོ
འཆིདེ	འཆི་མེད
འཆིེད	འཆི་མེད
འཆིོར	འཆི་སྦྱོར
འཆྱིོར	འཆི་སྦྱོར
འཆྱོིར	འཆི་སྦྱོར
འཆོསྐྱོབ	འཆོས་སྐྱོབ
འཇབེ༹	འཇབ་ཙེ
འཇཾལྱིངས	འཇམ་དཔལ་གྱི་དབྱངས
འཇཾལྱི	འཇམ་དཔལ་གྱི
འཇཾལྱིས	འཇམ་དཔལ་གྱིས
འཇཾལ་རྡོེ	འཇམ་དཔལ་རྡོ་རྗེ
འཇཾལ	འཇམ་དཔལ
འཇཾངས	འཇམ་དབྱངས
འཇཾཡངས	འཇམ་དབྱངས
འཇྱཾངས	འཇམ་དབྱངས
འཇྱཾངས	འཇམ་དབྱངས
འཇམགོན	འཇམ་མགོན
འཇཾགོན	འཇམ་མགོན
འཇམཉེན	འཇམ་མཉེན
འཇ༹ཾསེ	འཇམ་མཛེས
འཇཾརྡོར	འཇམ་རྡོར
འཇཾང༌	འཇམ་ལྗང༌
འཇཾ	འཇམ
འôན་	འཇའ་ཆོན
འཇོན	འཇའ་ཆོན
འཇོ༹ན	འཇའ་ཚོན
ཇོ༹ན	འཇའ་ཚོན
ཇའོདང	འཇའ་འོད་དང
འཇའོད	འཇའ་འོད
འཇོའད	འཇའ་འོད
འཇིགྙི	འཇིག་ཉི
འཇིགྲེན	འཇིག་འདྲེན
འཇིགསེརཐུབ	འཇིག་གསེར་ཐུབ
འཇིགེན་གསུཾ	འཇིག་རྟེན་གསུམ
འནིེམེའིསྲདི	འཇིག་རྟེན་མིའི་སྲིད་པ
འཇིགེན	འཇིག་རྟེན
འཇིནེ	འཇིག་རྟེན
འཇིེན	འཇིག་རྟེན
འིཏེན	འཇིག་རྟེན
འིནེ	འཇིག་རྟེན
འིེན	འཇིག་རྟེན
འཇིཌེན	འཇིགས་རྟེན
འཇིཊེད	འཇིགས་བྱེད
འཇྱིདེ	འཇིགས་བྱེད
འཇྱིེད	འཇིགས་བྱེད
འཇིཊེདཾ	འཇིགས་མེད
འཇིཊ་སུ	འཇིགས་སུ
འཇིགསྐྲག	འཇིགས་སྐྲག
འཇིཌ	འཇིགས
འཇིབྱེད	འཇིབ་བྱེད
འཇོུག	འཇུག་ལྡོག
འཇུཾད	འཇུར་མདུད
འཇོེག	འཇོ་སྒེག
འཇོགོས	འཇོག་དགོས
འཇྱོདེ	འཇོམས་བྱེད
འཇྱོམད	འཇོམས་བྱེད
འཇོཾས	འཇོམས
འཇོལོ	འཇོལ་མོ
འཇཽལ	འཇོལ་འཇོལ
འཐདཾ	འཐད་དམ
འཐབྲལ	འཐབ་བྲལ
འཐཱས	འཐས་འཐས
འཐཱུལ	འཐུལ་འཐུལ
འཐོརླུང	འཐོར་རླུང
འདབདག	འདབ་བདག
འདབཟང	འདབ་བཟང
འདབརྒྱ	འདབ་བརྒྱ
འདབརྒྱད	འདབ་བརྒྱད
འདབསུ	འདབས་སུ
འདཾ༹བ	འདམ་རྫབ
འདཾ	འདམ
འདརང	འདར་དང
འདསར	འདས་པར
འདསོ	འདས་སོ
འདིག	འདི་དག
འདིེས	འདི་བཞེས
འདིརེཊ	འདིར་གཤེགས
འདེུད	འདུ་བྱེད
འདྲོུད	འདུ་འཕྲོད
འདྲུལ	འདུ་འབྲལ
འདིུ༹	འདུ་འཛི
འདེུས	འདུ་ཤེས
འདུགནས	འདུག་གནས
འདུགིན	འདུག་གིན
འདུགོ	འདུག་གོ
འདུལིཛནཆྱོྃ	འདུན་འཛིན་མཆོག
འདུལྱེད	འདུལ་བྱེད
འདུསོ	འདུས་སོ
འདེབསཔོ	འདེབས་པའོ
འདེབསུ	འདེབས་སུ
འདྲོུག	འདོ་དྲུག
འདོདི	འདོད་ཀྱི
འདོདཾས	འདོད་ཁམས
འདོདགས	འདོད་ཆགས
འདོདཊ	འདོད་ཆགས
འདོདགུ	འདོད་དགུ
འདོུས	འདོད་དུས
འདོདྲལ	འདོད་བྲལ
འདཽདན	འདོད་ཡོན
འདོདོན	འདོད་ཡོན
འདཽན	འདོད་ཡོན
འདོལྡན	འདོད་ལྡན
འདོདསྲེདཇིགྲེད	འདོད་སྲེད་འཇིག་དྲེད
འདོཾན	འདོན་མཁན
འདཽལ	འདོལ་འདོལ
འདོལྃ	འདོལ་ལམ
འདྲཔེ	འདྲ་དཔེ
འདྲེཀར	འདྲེ་དཀར
འདྲེས༹ལ	འདྲེས་ཚལ
འདྲོཌ་	འདྲོགས་
འཕྱའི	འཕགས་པའི
འཕགསོ	འཕགས་སོ
འཕགསྐྱེསོ	འཕགས་སྐྱེས་པོ
འཕྱ	འཕགས
འཕེཾན	འཕེན་མཁན
འཕེབསོ	འཕེབས་སོ
འཕེལྱི	འཕེལ་གྱི
འཕེལྙི	འཕེལ་ཉི
འཕེལྱོགས	འཕེལ་ཕྱོགས
འཕེལྱོཊ	འཕེལ་ཕྱོགས
འཕྱེོཊ	འཕེལ་ཕྱོགས
འཕྲོང	འཕོ་བྲང
འཕོངསྐྱོབཾ	འཕོངས་སྐྱོབ་མ
འཕྲེན	འཕྲ་ཆེན
ཕྲིསྲུབརྃཛད་	འཕྲིན་ལས་འགྲུབ་པར་མཛོད་
ཕྲིསྒྲུབས	འཕྲིན་ལས་སྒྲུབས
ཕྲིས	འཕྲིན་ལས
འཕྲིནས	འཕྲིན་ལས
འཕྲིས	འཕྲིན་ལས
འཕྲུལོར	འཕྲུལ་འཁོར
འཕྲོུར	འཕྲུལ་འཁོར
འཕྲེདུ	འཕྲེད་དུ
འཕྲིནས	འཕྲིན་ལས
འཕྲོགསོ	འཕྲོགས་སོ
འབགུ	འབག་འབུག
འབདར	འབད་པར
འབེཾད	འབད་མེད
འབོ༹ལ	འབད་རྩོལ
འབབྱེད	འབབ་བྱེད
འབགི	འབའ་ཞིག
འབཻརུ	འབའ་རེ་འབུར་རེ
འབརུ	འབར་འབུར
འབིཌདེ	འབིགས་བྱེད
འབིཌ	འབིགས
འབུགྲོགྶགྶགྶགྶིགགུལནས	འབུ་གྲོག་སག་སག་སག་སིག་འགུལ་ནས
འབུནག	འབུ་ནག
འབུཾག	འབུམ་ཕྲག
འབྲུཾག	འབུམ་ཕྲག
འབུམོ་	འབུམ་མོ་
འབུཾ	འབུམ
འབཱུར	འབུར་འབུར
འབོདུངོ༌	འབོད་དུ་འོང༌
འབྱཾས་པ	འབྱམས་པ
འབྱུངས	འབྱུང་ཁུངས
འབྱུངས	འབྱུང་གནས
འབྱུངོ༌	འབྱུང་པོ
འབྱོུང	འབྱུང་པོ
འབུཾ	འབུམ
འབྱཾས	འབྱམས
འབྱེུད	འབྱེད་སྡུད
འབྲལདུྃ	འབྲལ་འདུམ
འབྲསཀར	འབྲས་དཀར
འབྲསགེ	འབྲས་དགེ
འབྲས་བུཞི	འབྲས་བུ་བཞི
འབྲུསསྐྱེད	འབྲས་བུ་བསྐྱེད
འབྲུས	འབྲས་བུ
འབྲསེནོ	འབྲས་རྗེན་པོ
འབྲསེན	འབྲས་རྗེན
འབྲསིལ	འབྲས་སིལ
འབྲསྤུངས	འབྲས་སྤུངས
འབྲུངས	འབྲས་སྤུངས
འབྲོུགས	འབྲུ་བོགས
འབྲུ༹	འབྲུ་ཚ
འབྲུསྨནོ་	འབྲུ་སྨན་ནོ
འབྲུགི་ལོ	འབྲུག་གི་ལོ
འབྲུགི	འབྲུག་གི
འབྲུཾ་བུ	འབྲུམ་བུ
འབྲེལེཾད	འབྲེལ་མེད
འཚབུ	འཚབ་འཚུབ
འཚཾར	འཚམ་པར
འཚུཾ	འཚམ་ཞུ
འཚཾདེ	འཚམས་མེད
འཚེམད	འཚམས་མེད
འཚུཾས	འཚམས་ཞུས
འཾ༹སུ	འཚམས་སུ
འཚཾས	འཚམས
འཚརོ	འཚར་མོ
འཚཱུབ	འཚུབ་འཚུབ
འཚྱོེད	འཚེ་སྐྱོང
འཚོསི༹	འཚོ་ཚིས
འཚོིས	འཚོ་ཚིས
འཚྱོང༌	འཚོ་སྐྱོང༌
འཛགཛོགོང་	འཛག་འཛོག་གོང་
འ༹ངསྤྱོད	འཛངས་སྤྱོད
འ༹ད	འཛད
འ༹ནོ	འཛན་པོ
འཛླིང༌	འཛམ་གླིང༌
འཛླམིང	འཛམ་གླིང
འཛླིང	འཛམ་གླིང
འཛཾ+ལིང	འཛམ་གླིང
འཛཾ+ལིམ	འཛམ་གླིམ
འུཾ༹	འཛམ་བུ
འཛཾ	འཛམ
འི༹ན་པ	འཛིན་པ
འི༹ནཾ	འཛིན་མ
འདིནེཾད་	འཛིན་མེད་
འི༹ན	འཛིན
འཛུཾག	འཛུམ་བག
འཛཱུམ	འཛུམ་འཛུམ
འཛེཾདེ	འཛེམ་མེད
འཛཱོང	འཛོང་འཛོང
འཛཽང	འཛོང་འཛོང
འཛེམེད	འཛོམ་མེད
འཛོཾས	འཛོམས
འརུ	འར་འུར
འལོ	འལ་འོལ
འུབསྡུས	འུབས་བསྡུས
འུརྖསླསྐྲ	འུར་ཆ་སླས་སྐྲ
འཱུར	འུར་འུར
འུརྡོ	འུར་རྡོ
འོུཾ༹ནི	འོ་མ་འཛིན
འོཾ	འོ་མ
འོཐུང	འོ་འཐུང
འོཛིན	འོ་འཛིན
འོགཞི	འོག་གཞི
འོགིསོ	འོག་གི་གོས
འོགི	འོག་གི
འོགིས	འོག་གིས
འོགྟུ	འོག་ཏུ
འོགཾ	འོག་མ
འོགིན	འོག་མིན
འོགེད	འོག་མེད
འོགཚུད	འོག་ཚུད
འོགཁྲུག	འོག་འཁྲུག
འོཾ	འོང
འོདྱིས	འོད་ཀྱིས
འོདསྱལ	འོད་གསལ
འོདལ	འོད་གསལ
འོདན	འོད་ཅན
འོདཀར་ཅན	འོད་དཀར་ཅན
འོདཀར	འོད་དཀར
འོདར	འོད་དཀར
འོེདར	འོད་དཀར
འོདཔགེད	འོད་དཔག་མེད
འོདཔགེཾད	འོད་དཔག་མེད
འོདམར	འོད་དམར
འོདུ	འོད་དུ
འོདྲེངན	འོད་ཕྲེང་ཅན
འོདུན	འོད་བདུན
འོདྱེད	འོད་བྱེད
འོདེ༹ས	འོད་མཛེས
འོདེརན	འོད་ཟེར་ཅན
འོདེརབྱངེཾས	འོད་ཟེར་བྱང་སེམས
འོདརེབྯུང	འོད་ཟེར་རབ་ཟུང
འོདེར	འོད་ཟེར
འོེད༹ར	འོད་ཟེར
འོེར	འོད་ཟེར
འོདེ༹ར	འོད་ཟེར
འོདུ	འོད་འཕུར
འོདྲོ	འོད་འཕྲོ
འོདཕྲོསྦྱང	འོད་འཕྲོས་སྦྱང
འདྲཽས	འོད་འཕྲོས
འོདྲོས	འོད་འཕྲོས
འོདེ༹ར	འོད་འཚེར
འོལྡན	འོད་ལྡན
འོདྡན	འོད་ལྡན
འོདྲུང	འོད་སྲུང
འོདྲུངསྡེ	འོད་སྲུངས་སྡེ
འོདྲུངས	འོད་སྲུངས
འོམུ	འོམ་བུ
འོརེས	འོར་རེས
འོལོ༹ད	འོལ་ཚོད
འོལྱི	འོལ་སྤྱི
འོསེུ	འོས་སུ་ཆེ
ཡ༹ནས	ཡ་མཚན་ནས
ཡ༹ན	ཡ་མཚན
ཡྃཚན	ཡ་མཚན
ཡྱོ	ཡ་ཡོ
ཡཻརེ	ཡ་རེ་ཡེར་རེ
ཡངྒི་	ཡང་གི་
ཡངལ	ཡང་ངལ
ཡང་དགལས	ཡང་དག་གསལ
ཡྲཾག་ཐྱ	ཡང་དག་ཐུགས
ཡྔཾགའིབོད	ཡང་དག་པའི་བོད
ཡངྡགར	ཡང་དག་པར
ཡངདག	ཡང་དག
ཡྡཾག	ཡང་དག
ཡྲཾག	ཡང་དག
ཡྔྃ་	ཡང་མ་
ཡངྃདེའི	ཡང་མེད་པའི
ཡྃངེདའི	ཡང་མེད་པའི
ཡྔང་	ཡང་ཡང་
ཡྃསྤ་	ཡངས་པ་
ཡངོད	ཡང་འབོད
ཡངངསོཾས	ཡང་ཡང་སོམས
ཡངང༌	ཡང་ཡང༌
ཡཱང	ཡང་ཡང
ཡངང	ཡང་ཡང
ཡྃསིང	ཡངས་ཤིང
ཡནྐོང༌	ཡན་ཀོང༌
ཡནྱི་	ཡན་གྱི་
ཡནདུ	ཡན་ཆད་དུ
ཡནད	ཡན་ཆད
ཡནད	ཡན་ཆད
ཡྣད	ཡན་ཆད
ཡནུ	ཡན་དུ
ཡནགི	ཡན་ལག་གི
ཡནགན	ཡན་ལག་ཅན
ཡནླགཅིུས	ཡན་ལག་བཅུ་གཉིས
ཡནག	ཡན་ལག
ཡནླག	ཡན་ལག
ཡླག	ཡན་ལག
ཡབ་སྲས	ཡབ་དང་སྲས
ཡུབཾ	ཡབ་ཡུམ
ཡུཾ	ཡབ་ཡུམ
ཡུཾབ	ཡབ་ཡུམ
ཡུཾཨབ	ཡབ་ཡུམ
ཡབོ	ཡབ་ཡོབ
ཡབྲས	ཡབ་སྲས
ཡུཾ	ཡམ་བུ
ཡམོ	ཡམ་ཡོམ
ཡཾ	ཡམ
ཡཱལ	ཡལ་ཡལ
ཡལལ	ཡལ་ཡལ
ཡལུ	ཡལ་ཡུལ
ཡལོང༌	ཡལ་སོང༌
ཡསྟཊ	ཡས་སྟགས
ཡསྟགས	ཡས་སྟབས
ཡིེསློབྡུསྲོ་	ཡི་གེ་སློབ་དུས་སྲོ་
ཡིགེ	ཡི་གེ
ཡིེ	ཡི་གེ
ཡིགསརྐྲུན	ཡིག་གསར་སྐྲུན
ཡི་དཾ	ཡི་དམ
ཡིདཾ	ཡི་དམ
ཡིགེ	ཡིག་གེ
ཡིགེའི	ཡིག་གེའི
ཡིགེར	ཡིག་གེར
ཡིདགའ	ཡིད་དགའ
ཡིདབང༌	ཡིད་དབང༌
ཡིདཾ	ཡིད་དམ
ཡིདོུང༌	ཡིད་དུ་འོང༌
ཡིདུ	ཡིད་དུ
ཡིནོ་	ཡིན་ནོ་
ཡྣིངི	ཡིན་ཞིང
ཡྣིལ	ཡིན་ལ
ཡིནིང༌	ཡིད་བཞིན་དབང༌
ཡིདནིུརོ	ཡིད་བཞིན་ནོར་བུ
ཡིདིན	ཡིད་བཞིན་ནོར་བུ
ཡིདིནུར	ཡིད་བཞིན་ནོར་བུ
ཡིནོརུ	ཡིད་བཞིན་ནོར་བུ
ཡིདནི	ཡིད་བཞིན
ཡིདམུག	ཡིད་མུག
ཡིད་ལསྐྱེས	ཡིད་ལས་སྐྱེས
ཡིནྱི	ཡིན་གྱི
ཡིནམིན	ཡིན་ནམ་མིན
ཡིནཾ	ཡིན་ནམ
ཡིནོ	ཡིན་ནོ
ཡིནར	ཡིན་པར
ཡུགི	ཡུག་གི
ཡུནས	ཡུན་གནས
ཡུནི་	ཡུན་ནི་
ཡུནིྃ	ཡུན་མི
ཡུནྲིངགིན	ཡུན་སྲིང་གིན
ཡུནྲིངསིག	ཡུན་སྲིངས་ཤིག
ཡེུནཾ	ཡུམ་ཆེན
ཡེུཾན	ཡུམ་ཆེན
ཡུཾཨེན	ཡུམ་ཆེན
སྲས༡༧	ཡུམ་སྲས་བཅུ་བདུན
ཡུཾ	ཡུམ
ཡུརཾ	ཡུར་མ
ཡུལན	ཡུལ་ཅན
ཡུལྟེཡུལྲུག	ཡུལ་ཏེ་ཡུལ་དྲུག
ཡུལབྣུས	ཡུལ་དབུས་ནས
ཡུལྃ	ཡུལ་ལམ
ཡུལྔ	ཡུལ་ལྔ
ཡུལྗོངས	ཡུལ་ལྗོངས
ཡུལྷ	ཡུལ་ལྷ
ཡུལཾས	ཡུལ་ལོངས
ཡུལྐད	ཡུལ་སྐད
ཡཻས་ཐིགེ	ཡེ་ཤེས་ཐིག་ལེ
ཡཻས་མཐའས	ཡེ་ཤེས་མཐའ་ཡས
ཡཻསོ༹ད	ཡེ་ཤེས་མཛོད
ཡཻ་སེཾདའ	ཡེ་ཤེས་སེམས་དཔའ
ཡཻསཾདའ	ཡེ་ཤེས་སེམས་དཔའ
ཡཻསྐུ	ཡེ་ཤེས་སྐུ
ཡཻས	ཡེ་ཤེས
ཡཻས	ཡེ་ཤེས
ཡེམེ་བ	ཡེམ་མེ་བ
ཡོའི	ཡོ་བའི
ཡྱོདེ་	ཡོ་བྱད་དེ་
ཡོྱད	ཡོ་བྱད
ཡྱོད	ཡོ་བྱེད
ཡོ་ཁྱོགྲོངཾཁན	ཡོ་འཁྱོག་སྲོང་མཁན
ཡོངས་འཇོཾས	ཡོངས་འཇོམས
ཡོཾངས	ཡོངས་འཇོམས
ཡངཽགས	ཡོངས་རྫོགས
ཡོངོ༹ཊ	ཡོངས་རྫོགས
ཡོངསྲོུལ	ཡོངས་སུ་གྲོལ
ཡོངསུ་རྫོགསོ	ཡོངས་སུ་རྫོགས་སོ
ཡོངསུ	ཡོངས་སུ
ཡོཾསུ	ཡོངས་སུ
ཡོངསྲུང༌	ཡོངས་སྲུང༌
ཡོདགུ	ཡོད་དགུ
ཡོདཾ	ཡོད་དམ
ཡོདེ	ཡོད་དེ
ཡོདོ	ཡོད་དོ
ཡོདའི	ཡོད་པའི
ཡོདར	ཡོད་པར
ཌར	ཡོད་པར
ཡོནས	ཡོན་གནས
ཡོྟནོད	ཡོན་ཏན་འོད
ཡོྟན་རྒྱེར	ཡོན་ཏན་རྒྱ་ཆེར
ཡོྟན	ཡོན་ཏན
ཡོྟན	ཡོན་ཏན
ཡོནག	ཡོན་བདག
ཡཽནད	ཡོན་མཆོད
ཡཽམ	ཡོམ་ཡོམ
ཡོལོ	ཡོལ་གོ
རྦ	ར་བ
རྱོདྃཁནོ	ར་བྱེད་མཁན་ནོ
ར་ཡིགཉིས་པ	ར་ཡིག་གཉིས་པ
རངན	རང་གཞན
རངཞན	རང་གཞན
རངའོར	རང་འཁོར
རངི༌	རང་གི
རངིས	རང་གིས
རངོལ	རང་གྲོལ
རོངལ	རང་གྲོལ
རངག	རང་ཅག
རངསུ	རང་ཆས་སུ
རངཉྱིས	རང་ཉིད་ཀྱིས
རངིད་༡་པོ	རང་ཉིད་གཅིག་པོ
རངིད	རང་ཉིད
རངིན	རང་བཞིན
རིངན	རང་བཞིན
རྦྱུང	རང་བྱུང༌
རྱུངཾ	རང་བྱུང
རང༹ན	རང་མཚན
རཾང༹ན	རང་མཚན
རྲྱུང	རང་འབྱུང
རངང༌	རང་རང༌
རངིག	རང་རིག
རངོ	རང་རོང
རངྶོར	རང་སོར
རངསའི	རངས་པའི
རནཔའོ་	རན་པའོ
རབཟྱཌབགེཾད	རབ་གཟུགས་བག་མེད
རབད	རབ་ཆད
རབད	རབ་ཆད
རེཾན	རབ་ཆེན
རབའ	རབ་དགའ
རབགའ	རབ་དགའ
རབྱུངི་	རབ་བྱུང་གི་
རབརྗིད	རབ་བརྗིད
རབརྟན	རབ་བརྟན
རབསགས	རབ་བསགས
རབསྔཊ	རབ་བསྔགས
རབྱུང༌	རབ་བྱུང༌
རབྱེད	རབ་བྱེད
རབེདཾ	རབ་མེད
རབྱོས	རབ་མྱོས
རབྱཾས	རབ་འབྱམས
རབྱོར	རབ་འབྱོར
རབི	རབ་རིབ
རིབ	རབ་རིབ
རབོང༌	རབ་སྟོང༌
རབསྱི་	རབས་ཀྱི་
རམུ	རམ་བུ
རྃཙི	རམ་རྩི
རྃ	རམ
རལིྲ	རལ་གྲི
རལང	རལ་དང
རལན	རལ་བ་ཅན
རལྱཾས	རལ་འཁྱམས
རལྕོག	རལ་ལྕོག
རསྱུའོ	རས་རྒྱུའོ
རིང	རི་དང
རིོ	རི་བོ
རོི	རི་བོ
རིངོན	རི་བོང་ཅན
རིཁའྲི་	རི་མཁའ་རི་
ངརི་ོཾ	རི་མོ་
རིོྃ་	རི་མོ་
རོྃ་	རི་མོ་
རིོྃའི	རི་མོའི
རིབ	རི་རབ
རིབས	རི་རབས
རྱིུ	རི་རྒྱུ
རིསུལ	རི་སུལ
རིགནསློབ	རིག་གནས་སློབ
རིགནས	རིག་གནས
རིགསུཾ	རིག་གསུམ
རིགན	རིག་ཅན
རིགྲུག	རིག་པ་དྲུག
རིགའིསྟནྕོས	རིག་པའི་བསྟན་བཅོས
རིགྱེད	རིག་བྱེད
རིགི༹ན	རིག་འཛིན
རཱིག	རིག་རིག
རིག༹ལ	རིག་རྩལ
རིགསུཾགོན	རིགས་གསུམ་མགོན་པོ
རིགསུཾ	རིགས་གསུམ
རིགསུམ	རིགས་གསུམ
རིཊན	རིགས་ཅན
རིགྲུག	རིགས་དྲུག
རིུས	རིགས་རུས
རིགྔ	རིགས་ལྔ
རིགྔས	རིགས་ལྔ
རིགསྔཊ	རིགས་སྔགས
རིགསུ	རིགས་སུ
རིཌ	རིགས
རིཌ་	རིགས་
རིུང	རིང་ཐུང
རིངརྒྱུད	རིང་བརྒྱུད
རིངྲེལ	རིང་བསྲེལ
རིངྲེལ	རིང་བསྲེལ
རིོང	རིང་སོང
རིངསུ	རིངས་སུ
རིནངོ་	རིན་གོང་
རིནེ	རིན་ཅེན
རིནེ་གསུཾ	རིན་ཆེན་གསུམ
རིནེཆྱ་	རིན་ཆེན་མཆོག་
རིེནྲོུབ	རིན་ཆེན་དོན་གྲུབ
རིནེ་རྣཾ་གསུམ	རིན་ཆེན་རྣམ་གསུམ
རིནེ	རིན་ཆེན
རེིན	རིན་ཆེན
རིནྠང་	རིན་ཐང
རིནོེ	རིན་པོ་ཆེ
རོིེན	རིན་པོ་ཆེ
རིནྯང	རིན་བཟང
རིནི༹ན	རིན་འཛིན
རིྃ་	རིམ་
རིྃཆེནོས	རིམ་ཆེན་པོས
རིཔྃནིུ	རིམ་པ་བཞིན་དུ
རིཾར	རིམ་པར
རིརྃ	རིམ་པར
རིཾསད	རིམས་ཅད
རིསྃ	རིམས
རིའིར	རིའི་བར
རིའོསིལསུཾ	རིའོ་བསིལ་གསུམ
རོའི	རིའོ
རིལུ	རིལ་བུ
རིལཾ	རིལ་མ
རིལཛིན	རིལ་འཛིན
རིསྲུག	རིས་དྲུག
རོུན	རུ་དཔོན
རུ༹ན	རུ་མཚན
རོུ༹ན	རུ་མཚོན
རོུན	རུ་མཚོན
རིུ༹ངས	རུ་འཛིངས
རུྃ	རུམ
རུལྶུངས	རུལ་སུངས
རུསན	རུས་ཅན
རུསའི	རུས་པའི
རུསྐྱེད	རུས་བསྐྱེད
རུསེ༹ར	རུས་མཛེར
རོུ༹ད	རུས་མཛོད
རུསྦལྱི	རུས་སྦལ་གྱི
རུསྦལན	རུས་སྦལ་ཅན
རུསྦལ	རུས་སྦལ
རུསྦོས	རུས་སྦོས
རེལ	རེ་རལ
རཻ	རེ་རེ
རཻར	རེ་རེར
རེཾས	རེངས
རེདོ	རེད་དོ
རཻམ	རེམ་རེམ
རེསཟྱའང	རེས་གཟའ་དང
རེསཟྱའཾཐུནཾ	རེས་གཟའ་མཐུན་ནམ
རོཙ་	རོ་ཙ་
རོ༹	རོ་ཙ
རོིན	རོ་འཛིན
རོུལ་བ	རོ་རུལ་བ
རོགེ	རོག་གེ
རོགོ	རོག་གོ
རོཌ་	རོགས་
རུངོལ	རོང་ཡུལ
རོུལ	རོང་ཡུལ
རོབ༹མ	རོབ་ཙམ
རོལཁུག	རོལ་ཁུག
རོལྟེ	རོལ་ཏེ
རོལྲུག	རོལ་དྲུག
རོལྣ་	རོལ་ན་
རོལོ༹	རོལ་མཚོ
རོལོཾ	རོལ་མོ
རོལྨོ	རོལ་མོ
རྐངམྱོང	རྐང་མགོ་དང
རྐངྶོན	རྐང་སེན
རྐངྶོར	རྐང་སོར
རྐྱོདེ	རྐོ་བྱེད
རྐྱྱང	རྐྱང་རྐྱང
རྐྱེནྲོཊར	རྐྱེན་ངན་གྲོགས་ཤར
རྐྱེནང	རྐྱེན་དང
རྒི	རྒ་ཤི
རྒནྖཌ་	རྒན་ཆགས་
རྒནོ	རྒན་པོ
རྒནོཾ	རྒན་མོ
རྒསྱང	རྒས་ཀྱང
རྒསྠུནྃཚས	རྒས་ཐུན་མཚམས
རྒྲུམ	རྒུན་འབྲུམ
རྒོདའི	རྒོད་པའི
རྒྱ་བོད	རྒྱ་གར་དང་བོད
རྒྱར	རྒྱ་གར
རྒྱ་གྲཾ	རྒྱ་གྲམ
རྒྱྲམ	རྒྱ་གྲམ
དྱེ་	རྒྱ་ཆེ་
དྱནྱེོདེ	རྒྱ་ཆེན་པོ་བྱེད
དྱནེོ	རྒྱ་ཆེན་པོ
རྒྱེར	རྒྱ་ཆེར
རྒྱ་བོད	རྒྱ་ནག་དང་བོད
དྱནགང	རྒྱ་ནག་དང
རྒྱག	རྒྱ་ནག
རྒྱོད	རྒྱ་བོད
རྒྱམོ	རྒྱ་མཚོ
རྒྱོ༹	རྒྱ་མཚོ
རྒྱོཾ༹	རྒྱ་མཚོ
རྒྱོ༹མ	རྒྱ་མཚོ
རྪོ	རྒྱ་མཚོ
དྱཾཚོ	རྒྱ་མཚོ
དྱོཾ༹	རྒྱ་མཚོ
དྱཚོའི	རྒྱ་མཚོའི
རྒྱོཾའི	རྒྱ་མཚོའི
ངྱོ༹ར	རྒྱ་མཚོར
ངྱོ༹ར	རྒྱ་མཚོར
རྒྱོ༹ཾར	རྒྱ་མཚོར
དྱྃའི	རྒྱ་མའི
རྒྱཱ	རྒྱ་རྒྱ
དྱརྙིངདྃའཞུན	རྒྱ་རྙི་མདའ་གཞུ་ཅན
དྱ	རྒྱ
ངྱག	རྒྱག
ངྱག	རྒྱག
རྒྱནྱི	རྒྱན་གྱི
དྱནོ	རྒྱན་ནོ
དྱན	རྒྱན
རྒྱབཀྲ	རྒྱབ་བཀྲ
རྒྱབཤུལ	རྒྱབ་བཤུལ
དྱབ	རྒྱབ
དྱལྑབ	རྒྱལ་ཁབ
རྒྱལྲིཾས	རྒྱལ་ཁྲིམས
ངྱལེན་སྡེ་༩	རྒྱལ་ཆེན་སྡེ་དགུ
ངྱལེན་སྡེ་༩	རྒྱལ་ཆེན་སྡེ་དགུ
རྒྱལེན	རྒྱལ་ཆེན
ལེན	རྒྱལ་ཆེན
རྒྱལ་བློན	རྒྱལ་པོ་དང་བློན་པོ
རྒྱལོ	རྒྱལ་པོ
རྒྱོལ	རྒྱལ་པོ
རྒྱལོའི་གདུང་ངྱུད	རྒྱལ་པོའི་གདུང་རྒྱུད
རྒྱལོའི་གདུང་ངྱུད	རྒྱལ་པོའི་གདུང་རྒྱུད
རྒྱལོའི	རྒྱལ་པོའི
རྒྱལོས	རྒྱལ་པོས
རྒྱལཾ	རྒྱལ་ཕམ
རྒྱལའི	རྒྱལ་བའི
དྱལྦ	རྒྱལ་བ
དྱལོ་	རྒྱལ་བོ་
དྱལློ་	རྒྱལ་བོ་ཟླ་
དྱལོའོ་	རྒྱལ་བོའོ་
རྒྱལྱུད	རྒྱལ་བརྒྱུད
རྒྱལུ	རྒྱལ་བུ
རྒྱལྱེད	རྒྱལ་བྱེད
རྒྱལོན	རྒྱལ་བློན
དྱལྃཆུ	རྒྱལ་མཆུ
དྱལཚནོ	རྒྱལ་མཚན་ནོ
རྒྱ༹ན	རྒྱལ་མཚན
རྒྱལ༹ན	རྒྱལ་མཚན
དྱྃཚན	རྒྱལ་མཚན
དྱལ༹ན	རྒྱལ་མཚན
དྱལཾ༹ཨན	རྒྱལ་མཚན
དྱལཾཨོ	རྒྱལ་མོ
ངྱལ་ཚབ	རྒྱལ་ཚབ
ངྱལ་ཚབ	རྒྱལ་ཚབ
ངྱལ༹བ	རྒྱལ་ཚབ
ངྱལ༹བ	རྒྱལ་ཚབ
རྒྱལ༹བ	རྒྱལ་ཚབ
དྱལཚོཌ་	རྒྱལ་ཚོགས་
ངྱལ་ས	རྒྱལ་ས
ངྱལ་ས	རྒྱལ་ས
རྒྱལོད	རྒྱལ་སྟོད
རྒྱལད	རྒྱལ་སྨད
རྒྱལྲས	རྒྱལ་སྲས
དྱལྲསྖེནོ་	རྒྱལ་སྲས་ཆེན་པོ་
དྱསྲིདར	རྒྱལ་སྲིད་དར
དྱལྲིད༧	རྒྱལ་སྲིད་བདུན
རྒྱལྲིད	རྒྱལ་སྲིད
དྱསཙུགླགཁངི	རྒྱས་གཙུག་ལག་ཁང་གི
ངྱས་པ	རྒྱས་པ
ངྱས་པ	རྒྱས་པ
དྱསའྡིེ་	རྒྱས་པའི་སྡེ་
རྒྱསར	རྒྱས་པར
དྱསཤད	རྒྱས་བཤད
དྱསིང	རྒྱས་ཤིང
དྱསོ	རྒྱས་སོ
དྱས	རྒྱས
དྱས	རྒྱས
རྒྱུ༹ན	རྒྱུ་མཚན
རྒྱེུད	རྒྱུ་མེད
རྒྱུྃདེ	རྒྱུ་མེད
རྒྱེུན	རྒྱུ་རྐྱེན
རྒྱོུར་ཡོནག	རྒྱུ་སྦྱོར་ཡོན་བདག
རྒྱོུར	རྒྱུ་སྦྱོར
རྒྱུ	རྒྱུ
རྒྱུདག་པ	རྒྱུད་དག་པ
རྒྱུདོ	རྒྱུད་དོ
ངྱུད	རྒྱུད
ངྱུད	རྒྱུད
རྒྱུནུ	རྒྱུན་དུ
ངྱུན་མི་འཆད	རྒྱུན་མི་འཆད
ངྱུན་མི་འཆད	རྒྱུན་མི་འཆད
རྒྱུནྃཐུད	རྒྱུན་མཐུན་
རྒྱུནྱཾས	རྒྱུན་འབྱམས
རྒྱུཾས	རྒྱུན་འབྱམས
རྒྱུ༹་ནི	རྒྱུན་འཛིན
ངྱུན	རྒྱུན
ངྱུན	རྒྱུན
རྒྱཽབ	རྒྱོབ་རྒྱོབ
རྔབུ	རྔབ་རྔུབ
རྔཾས	རྔམས
རྔོགྯེར	རྔོག་ཟེར
རྗེནས	རྗེ་ནས
རྗེཙུན	རྗེ་བཙུན
རྗེུན༹	རྗེ་བཙུན
རྗེུན	རྗེ་བཙུན
རྫེུན	རྗེ་བཙུན
རྫེན	རྗེ་བཙུན
རྗེསོར	རྗེས་གསོར
རྗེསྠོབ	རྗེས་ཐོབ
རྗེསྲན	རྗེས་དྲན
རྗེསཾ	རྗེས་མ
རྗེསཇུག	རྗེས་འཇུག
རྗེསུ	རྗེས་སུ
རྗེསོ	རྗེས་སོ
རྗེསོར	རྗེས་སོར
རྗེསྐྱེས	རྗེས་སྐྱེས
རྙནྱི	རྙན་གྱི
རྙིངྑུངས	རྙིང་ཁུངས
རྙིངེ	རྙིང་ངེ
རྙིངྕསྱོས	རྙིང་བཅོས་བྱས
རྙིངསྟན	རྙིང་བསྟན
རྙིངྃ་	རྙིང་མ་
རྙིངཚད	རྙིང་ཚད
རྙིངྼུལ	རྙིང་རུལ
རྙིངྲྱུདཀརྖག	རྙིང་རྒྱུད་དཀས་ཆག
རྙིུངལ	རྙིང་ཤུལ
རྙིངྲུལ	རྙིང་ཧྲུལ
རྙིརྯིནར	རྙིར་ཟིན་འདྲ
རྙིལྣད	རྙིལ་ནད
རྙེདྠུབ	རྙེད་ཐུབ
རྙེདཀའ	རྙེད་དཀའ
རྙེདའི	རྙེད་པའི
རྙེདར	རྙེད་པར
རྙེདཀུརྃ་	རྙེད་བཀུར་མི་
རྙེདརྩོན	རྙེད་བརྩོན
རྙེདཚོལ	རྙེད་ཚོལ
རྙོགྲཟོས	རྙོག་གྲ་བཟོས
རྙོགཛིང	རྙོག་འཛིང
རྙོནི	རྙོན་ནི
རྙོབགི	རྙོབས་ཤིག
རྟྣོར	རྟ་ནོར
རྟརྒོད	རྟ་རྒོད
རྟྶར	རྟ་སར
རྟ	རྟ
རྟ	རྟ
རྟྲིན	རྟ་མགྲིན
ངྱུགས	རྟ་རྒྱུགས
ངྱུགས	རྟ་རྒྱུགས
ངྱུཊ	རྟ་རྒྱུགས
ངྱུཊ	རྟ་རྒྱུགས
རྟགནས	རྟག་གནས
རྟགྟུ	རྟག་ཏུ
རྟགློཾས	རྟག་ལོངས
རྟགླྟས	རྟག་ལྟས
རྟགསུ	རྟགས་སུ
རྟགསོ	རྟགས་སོ
རྟཌ	རྟགས
རྟཌ	རྟགས
རྟབོ	རྟབ་རྟོབ
རྟིངྃ་	རྟིང་མ་
རྟེནིང་འབྲེལུང༌	རྟེན་ཅིང་འབྲེལ་འབྱུང༌
རྟེནེལ	རྟེན་འབྲེལ
རྟེེལེ	རྟེན་འབྲེལ
རྟྲེེལ	རྟེན་འབྲེལ
རྟོགེ	རྟོག་གེ
རྟོགི་	རྟོག་གི་
རྟོགྱེདང	རྟོག་བྱེད་དང
རྟོཌ	རྟོགས
སྟོཌ	རྟོགས
རྟོཌ་	རྟོགས་
རྟོཌའི	རྟོགས་པའི
རྟོགསུ	རྟོགས་སུ
རྟོཊུ	རྟོགས་སུ
རྟོཌོ	རྟོགས་སོ་
རྟོཌ	རྟོགས
རྡརྱེད	རྡར་བྱེད
རྡེུ༹ཊ	རྡུལ་བརྩེགས
རྡུལྡན	རྡུལ་ལྡན
རྡོསྱིརཾདའསྱིར	རྡོ་གསིར་མདའ་གསིར
རྡོེ་གཞོནུ	རྡོ་རྗེ་གཞོན་ནུ
རྡོེ་དཔལྡན་ཚུལིྲས	རྡོ་རྗེ་དཔལ་ལྡན་ཚུལ་ཁྲིམས
རྡོེངས	རྡོ་རྗེ་དབྱངས
རྡོེང༌	རྡོ་རྗེ་འཆང༌
རྡོེའི༹ན	རྡོ་རྗེ་འཛིན
རྡོེའེཾ	རྡོ་རྗེ་སེམས་དཔའ
རྡོེེདཾས	རྡོ་རྗེ་སེམས་དཔའ
རྡོེ	རྡོ་རྗེ
རྡོརེ	རྡོ་རྗེ
རྡོེའི	རྡོ་རྗེའི
རྡོེའི	རྡོ་རྗེའི
རྡོེའོ་	རྡོ་རྗེའོ་
རྡྶོལོ	རྡོ་སོལ
རྣ	རྣ
རྣཾཡྱེང	རྣམ་གཡེང
རྣངཾས	རྣམ་གྲངས
རྣཾངས	རྣམ་གྲངས
རྣྲཾངས	རྣམ་གྲངས
རྣྲོཾལ	རྣམ་གྲོལ
རྣཾར	རྣམ་ཐར
རྣྠྃར་	རྣམ་ཐར་
རྣྲོཾས	རྣམ་ཐོས་སྲས
རྣཾག	རྣམ་དག
རྣམག	རྣམ་དག
རྣཾརག	རྣམ་པར་དག
རྣམྲག	རྣམ་པར་དག
རྣམ་པརྒྱལ	རྣམ་པར་རྒྱལ
རྣཾརང༹ད	རྣམ་པར་སྣང་མཛད
རྣརྨང༹ད	རྣམ་པར་སྣང་མཛད
རྣཾར	རྣམ་པར
རྣཾཨར	རྣམ་པར
རྣམཁྱེན	རྣམ་མཁྱེན
རྣཾནེ	རྣམ་མཁྱེན
རྣྱེཾན	རྣམ་མཁྱེན
རྣལྱོར	རྣམ་འབྱོར
རྣྱམལ	རྣམ་རྒྱལ
རྣྱཾལ	རྣམ་རྒྱལ
རྣོཾག	རྣམ་རྟོག
རྣོམག	རྣམ་རྟོག
རྣཾསེ	རྣམ་ཤེས
རྣེཾས	རྣམ་ཤེས
རྣེམས	རྣམ་སེཧས
རྣཾང༌	རྣམ་སྣང༌
རྣཾང༹ད	རྣམ་སྣང་མཛད
རྣམང	རྣམ་སྣང
རྣཾས	རྣམ་སྲས
རྣྲཾས	རྣམ་སྲས
རྣྃ	རྣམ
རྣཾསྱང༌	རྣམས་ཀྱང༌
རྣཾསྱི	རྣམས་ཀྱི
རྣཾསུཾ	རྣམས་གསུམ
རྣཾསསུཾ	རྣམས་གསུམ
རྣྃསང	རྣམས་དང
རྣྃསྣི་	རྣམས་ནི་
རྣཾསར	རྣམས་པར
རྣཾསཾརེཕུལ	རྣམས་མེར་ཕུལ
རྣྃསཚོཞིང	རྣམས་འཚོ་ཞིང
རྣཾསློབ	རྣམས་སློབ
རྣཾསུ	རྣམས་སུ
རྣཾས	རྣམས
རྣསཾ	རྣམས
རྣལྱོིས	རྣལ་འབྱོར་གྱིས
རྣལྱོཾར	རྣལ་འབྱོར་མ
རྣལྦྱོར	རྣལ་འབྱོར
རྣལྱོར	རྣལ་འབྱོར
རྣོར	རྣལ་འབྱོར
རྣྱོར	རྣལ་འབྱོར
རྣོརཾ	རྣོ་ངར
རྣོབལཕྲོགྱེདོ	རྣོ་དབལ་འཕྲོག་བྱེད་དོ
རྦདོ	རྦད་རྦོད
རྦཽདང	རྦོད་གཏོང
རྦོདོང༌	རྦོད་སྟོང༌
རྦཽདང	རྦོད་སྟོང
རྨེན	རྨ་ཆེན
རྨྱ་ཆེོན་ལསྱུང༌	རྨ་བྱ་ཆེན་མོ་ལས་འབྱུང༌
རྨྱ	རྨ་བྱ
རྨྱ	རྨ་བྱ
རྨ༹ན	རྨ་མཚན
རྨདུ་བྱུང༌	རྨད་དུ་བྱུང༌
རྨདུ	རྨད་དུ
རྣཾསང	རྨས་དང
རྨསྐྱོནཏང	རྨས་སྐྱོན་བཏང
རྨིཾ	རྨི་ལམ
རྨུཌ་	རྨུགས་
རྨུནོ	རྨུན་པོ
རྨོངསྦྲེ	རྨོངས་སྦྲེ
རྨོསོ	རྨོས་སོ
རྩོན	རྩ་བཏོན
རྩྱད	རྩ་བརྒྱད
རྩགི༹	རྩ་ཚིག
རྩྲེལ	རྩ་འགྲེལ
རྩྱུད	རྩ་རྒྱུད
རྩགི	རྩག་རྩིག
རྩྱེངར	རྩང་གྱེར
རྩྱེཾར	རྩང་གྱེར
རྩྱུཾར	རྩང་བརྒྱུར
རྩུངར	རྩང་བསྐུར
རྩུངལ	རྩང་བསྐུལ
རྩུཾལ	རྩང་བསྐུལ
རྩུལ	རྩང་བསྐུལ
རྩྟོཾད	རྩང་བསྟོད
རྩངི	རྩང་རྩིང
རྩྟོད	རྩང་སྟོད
རྩབུ	རྩབ་རྩུབ
རྩུལོ	རྩལ་དུ་གསོལ
རྩོུལ	རྩལ་དུ་གསོལ
རྩལྡན	རྩལ་ལྡན
རྩྲུབ	རྩལ་སྒྲུབ
རྩིཤིང	རྩི་ཤིང
རྩིགཟོ	རྩིག་བཟོ
རྩིགསུ	རྩིགས་སུ
རྩིབསྒོ	རྩིབས་སྒོ
རྩུབོ	རྩུབ་པོ
རྩེུཾན	རྩེ་གསུམ་ཅན
རྩྲུག	རྩེ་དྲུག
རྩྲེུག	རྩེ་དྲུག
རྩྲུང༌	རྩེ་དྲུང༌
རྩེོཾན	རྩེ་མོ་ཅན
རྩྔེོཾ	རྩེ་མོ་ལྔ
རྩྨོེམ	རྩེ་མོ་ལྔ
རྩེོ	རྩེ་མོ
རྩེོཾ	རྩེ་མོ
རྩོེ	རྩེ་མོ
རྩེྃ་	རྩེ་མོ་
རྩྱེལ	རྩེ་རྒྱལ
རྩྱུད	རྩེ་རྒྱུད
རྩྱེུད	རྩེ་རྒྱུད
རྩྔེ	རྩེ་ལྔ
རྩེདགའ	རྩེད་དགའ
རྩེནས	རྩེན་གནས
རྩེནྶོན	རྩེར་སོན
རྩོདེཾ	རྩོད་མེད
རྩོལྡན	རྩོད་ལྡན
རྩོམཁན	རྩོམ་མཁན
རྫནུ	རྫན་རྫུན
རྫབན	རྫབ་ཅན
རྫབོ	རྫབ་རྫོབ
རྫསྱི	རྫས་ཀྱི
རྫྱིས	རྫས་ཀྱིས
རྫུ་འཕྲུལྔ	རྫུ་འཕྲུལ་ལྔ
རྫྲུལྔ	རྫུ་འཕྲུལ་ལྔ
རྫུུལ	རྫུ་འཕྲུལ
རྫྲུལ	རྫུ་འཕྲུལ
རྫྲུལ	རྫུ་འཕྲུལ
རྫུས་ཾ	རྫུས་མའམ
རྫུསྐྱེས	རྫུས་སྐྱེས
རྫེུས	རྫུས་སྐྱེས
རྫེུན	རྫེ་བཙུན
རྫོཊེན	རྫོགས་ཆེན
རྫོེགསན	རྫོགས་ཆེན
རྫོཌེན	རྫོགས་ཆེན
རྫོཌའི	རྫོགས་པའི
རྫོགསངས	རྫོགས་སངས
རྫཽཌ་	རྫོགས་སོ་
རྫོཌ	རྫོགས
རྫོཊ	རྫོགས
རྫོཌ	རྫོགས
རྫྲོུང༌	རྫོང་སྲུང༌
རླངསརོང	རླངས་འཁོར
རླནོ	རླན་རློན
རླུང་གྲིུ	རླུང་གི་གྲུ
རློནཔ	རློན་པ
རློམྃནི	རློན་མིན
རླཽབ	རློབ་རློབ
རློྃ	རློམ
ལྲུ	ལ་ཁྲུ
ལཁྲོ	ལ་ཁྲོ
ལསྱང	ལ་གསང
ལསྱལྮགྕེསོ	ལ་གསལ་ཞག་ཅེསོ
ལླིང	ལ་གླིང
ལྔན	ལ་ངན
ལཏུ	ལ་ཏུ
ལདོན	ལ་དོན
ལདགོངས	ལ་དགོས
ལྱཚལོ	ལ་ཕྱག་འཚལ་ལོ
ལ༹ས	ལ་བཙས
ལརྟེན	ལ་བརྟེན
ལསྐྱོན	ལ་བསྐྱོན
ལྃཁས	ལ་མཁས
ལེཾར	ལ་མེར
ལུ༹ཊ་པ	ལ་ཚུགས་པ
ལྮིབདཔྱདབྱས	ལ་ཞིབ་དཔྱད་བྱས
ལྴང	ལ་ཤ་དང
ལོཌ་	ལ་སོགས་
ལཌོ	ལ་སོགས
ལྡང	ལ་སྡང
ལྲལེནྱེདགོས	ལ་སྲལ་ལེན་བྱེད་དགོས
ལྲུསྒངོརྯེ	ལ་སྲུས་གོང་ཟེར
ལྲེད	ལ་སྲེད
ལྲོལྱེ་	ལ་སྲོལ་ཕྱེ་
ལགཉིས	ལག་གཉིས
ལགདུབ	ལག་གདུབ
ལགཡས	ལག་གཡས
ལགཡོན	ལག་གཡོན
ལགི	ལག་གི
ལགིས	ལག་གིས
ལགྲོ	ལག་འགྲོ
ལགི༹ན	ལག་འཛིན
ལགེན	ལག་ལེན
ལགླེན	ལག་ལེན
ལགསཾ	ལགས་སམ
ལགྶེན	ལག་སེན
ལགྶོར	ལག་སོར
ལཌ་	ལགས་
ལཌ	ལགས
ལངོ༹	ལང་འཚོ
ལངི	ལང་ལིང
ལངོ	ལང་ལོང
ལནཌ	ལན་ཆགས
ལནྲུགྟུ	ལན་དྲུག་ཏུ
ལནུ	ལན་བུ
ལན༹ར	ལན་ཚར
ལནཚྭའིཚོང	ལན་ཚྭའི་མཚོ་དང
ལནྭ༹	ལན་ཚྭ
ལབོ	ལབ་ལོབ
ལམྱི་	ལམ་གྱི་
ལེཾན	ལམ་ཆེན
ལྃང	ལམ་དང
ལམདོ	ལམ་མདོ
ལོཾད	ལམ་མདོ
ལམེ་བ	ལམ་མེ་བ
ལམེད་པ	ལམ་མེད་པ
ལྔྃ	ལམ་ལྔ
ལྔྃའོ་	ལམ་ལྔའོ་
ལེྃསོཌ	ལམ་ཤེས་སོགས
ལྃ	ལམ
ལའངཤེསར	ལའང་ཤེས་པར
ལའིཕྱིངསྣིསཞྱིང	ལའི་ཕྱི་ངོས་ནི་ས་གཞི་དང
ལའིཕྱྲུབུཌ	ལའི་ཕྱི་རུ་དབུགས
ལསྱིའ	ལས་ཀྱི་མཐའ
ལསྱི་རྣཾསྨིན	ལས་ཀྱི་རྣམ་སྨིན
ལསྱི	ལས་ཀྱི
ལསྱིས	ལས་ཀྱིས
ལསྲུབ	ལས་གྲུབ
ལསྟེ	ལས་ཏེ
ལསྠར	ལས་ཐར
ལ༹ང༌	ལས་བཟང༌
ལསང	ལས་བཟང
ལསྱང༌	ལས་བྱང༌
ལྱང༌	ལས་བྱང༌
ལས༹ན	ལས་ཚན
ལྡས	ལས་འདས
ལྲས	ལས་འབྲས
ལསྱལའིཚནཾ	ལས་རྒྱལ་བའི་མཚན་མ
ལཱས་བཅཽས	ལས་ལས་བཅོས་བཅོས
ལསྒྲིབ	ལས་སྒྲིབ
ལསོཌ	ལས་སོགས
ལསྙནཾགི	ལས་སྙན་ངག་གི
ལསློ	ལས་སླ་པོ
ལསླ	ལས་སླ
ལིང	ལི་དང
ལྀ་	ལི་ལི་
ལིངྒ	ལིང་ག
ལཱིུ	ལཱུ་ཨི
ལུགིལོ	ལུག་གི་ལོ
ལུགི	ལུག་གི
ལཱུག	ལུག་ལུག
ལུགྶྟེསྐྱེ	ལུག་སྟེ་སྐྱེ
ལྱང	ལུགས་དང
ལུངསྲོལྯངོའི	ལུགས་སྲོལ་བཟང་བོའི
ལུགསུ	ལུགས་སུ
ལུཌ	ལུགས
ལུཌ	ལུགས
ལུངུབསྟནའི	ལུང་དུ་བསྟན་པའི
ལུངའི་	ལུང་པའི་
ལུངནའི	ལུང་བསྟན་པའི
ལུངྃསྟན	ལུང་བསྟན་མ
ལུངན	ལུང་བསྟན
ལུངྟན	ལུང་བསྟན
ལུངོན	ལུང་སྟོན
ལུངསུ	ལུངས་སུ
ལུམྦིའི་གནས	ལུམ་བིའི་གནས
ལུམྦིའི་ཚལ	ལུམ་བིའི་ཚལ
ལུསྱི	ལུས་ཀྱི
ལུསངིག༣	ལུས་ངག་ཡིད་གསུམ
ལུསྱངིད༣	ལུས་ངག་ཡིད་གསུམ
ལུཾགིད	ལུས་ངག་ཡིད
ལུསྱཾདི་གསུམ	ལུས་ངག་ཡིད
ལིུུདཾ	ལུས་ངག་ཡིད
ལུསན	ལུས་ཅན
ལུསདྲེག	ལུས་དྲེག
ལུསུ	ལུས་སུ
ལེུཾས	ལུས་སེམས
ལུསྐྱེས	ལུས་སྐྱེས
ལུསྐྱོབ	ལུས་སྐྱོབ
ལུསྟོབས	ལུས་སྟོབས
ལུསྲུང༌	ལུས་སྲུང༌
ལུསྲོ	ལུས་སྲོ
ལེ༹ན	ལེ་ཚན
ལེག	ལེ་ལག
ལེོ	ལེ་ལོ
ལེོའི	ལེ་ལོའི
ལེཌ་	ལེགས་
ལེཌགྲུབྶྶྟེ་	ལེགས་གྲུབ་སྟེ
ལེགསུང༌	ལེགས་གསུང༌
ལེཌའི་	ལེགས་པའི་
ལེཌའི	ལེགས་པའི
ལེཊར	ལེགས་པར
ལེཊད	ལེགས་བཤད
ལེགྡནཾ	ལེགས་ལྡན་མ
ལེགྡན	ལེགས་ལྡན
ལྡེགན	ལེགས་ལྡན
ལྡེན	ལེགས་ལྡན
ལེགསོ	ལེགས་སོ
ལེགསོ	ལེགས་སོ
ལོགསྐྱེས	ལེགས་སྐྱེས
ལེགསྦྱར	ལེགས་སྦྱར
ལེབྱར	ལེགས་སྦྱར
ལེགྱིནཾ	ལེགས་སྦྱིན་མ
ལེཊ	ལེགས
ལེཌ	ལེགས
ལེཌ	ལེགས
ལེནགས	ལེན་ཆགས
ལེནཊ	ལེན་ཆགས
ལེནུ	ལེན་དུ
ལེནའི	ལེན་པའི
ལེནུཚལདེ	ལེན་ཚུལ་བདེ
ལེབེབ	ལེབ་ལེབ
ལྦེ	ལེབ
ལེའུདངརོ	ལེའུ་དང་བོར
ལྔོོ་	ལོ་ངོ་
ལྖོེན	ལོ་ཆེན
ལོ་པཎ	ལོ་ཙཱ་བ་དང་པཎྜི་ཏ
ལོེགས	ལོ་ལེགས
ལཽན	ལོ་ལོན
ལྶོར	ལོ་སར
ལྐྱོ	ལོ་སྐྱ
ལོགཾ	ལོག་གམ
ལོགཡེམ	ལོག་གཡེམ
ལོགྲེན	ལོག་འདྲེན
ལྲོེན	ལོག་འདྲེན
ལོགོ༹	ལོག་འཚོ
ལཽག	ལོག་ལོག
ལོགསུ	ལོགས་སུ
ལོཌ་	ལོགས་
ལོགདྱབྴུལ	ལོགས་བརྒྱབ་ཤུལ
ལོངདེྃར	ལོང་མེད་པར
ལོངསའི་	ལོངས་པའི་
ལོཾསའི་	ལོངས་པའི་
ལོངསིག	ལོངས་ཤིག
ལོངསྐུ	ལོངས་སྐུ
ལོངསྤྱད་པ	ལོངས་སྤྱད་པ
ལོངོདཊོ	ལོངས་སྤྱོད་རྫོགས
ལོངསྤྱོད	ལོངས་སྤྱོད
ལོངསྱོད	ལོངས་སྤྱོད
ལྱོངོད	ལོངས་སྤྱོད
ལྱཽད	ལོངས་སྤྱོད
ལྱོངོད	ལོངས་སྤྱོད
ལྱོོོངདགས	ལོུངས་སྦྱོད་རྫོགས
ལོངསྦྱོད	ལོངས་སྦྱོད
ལྱཽངད	ལོངས་སྦྱོད
ལོཾས	ལོངས
ལོརྔོག	ལོར་རྔོག
ལྐོགསོདྯེར	ལྐོག་གསོད་ཟེར
ལྔྖའི་	ལྔ་ཆའི་
ལྔོ	ལྔ་བོ
ལྔ༹ན	ལྔ་ཚན
ལྔྶྡེ	ལྔ་སྡེ
ལྔ	ལྔ
ལྔ	ལྔ
ལྕཌ་	ལྕགས་
ལྕགྱུྃ	ལྕགས་ཀྱུ་མ
ལྕཀྱུ	ལྕགས་ཀྱུ
ལྕགུ	ལྕགས་ཀྱུ
ལྕུཊ	ལྕགས་ཀྱུ
ལྕཀྱུའི	ལྕགས་ཀྱུའི
ལྕཀྱུའོ	ལྕགས་ཀྱུའོ
ལྕཀྱུས	ལྕགས་ཀྱུས
ལྕྱོཊ	ལྕགས་ཀྱོ
ལྕཀྱོ	ལྕགས་ཀྱོ
ལྕཌགྃར	ལྕགས་མཁར
ལྕཌྃདའ	ལྕགས་མདའ
ལྕཌདྃང	ལྕགས་མདོང
ལྕཌྃགི	ལྕགས་མིག
ལྕཌོྃ་	ལྕགས་མོ་
ལྕཌསོག	ལྕགས་སོག
ལྕཌསླང	ལྕགས་སླང
ལྕགསྐུད	ལྕགས་སྐུད
ལྕྲོག	ལྕགས་སྒྲོག
ལྕགསྒྲོག	ལྕགས་སྒྲོག
ལྕགསྒྲོག	ལྕགས་སྒྲོག
ལྕྲོག	ལྕགས་སྒྲོག
ལྕཊ	ལྕགས
ལྕཌ་	ལྕགས
ལྕཌ	ལྕགས,
ལྕངྃ	ལྕང་མ
ལྕངོ	ལྕང་ལོ
ལྕངྐྱའི	ལྕང་སྐྱའི
ལྕྲྃལ	ལྕམ་དྲལ
ལྕོྃ	ལྕམ་མོ
ལྕྲྃངི	ལྕམ་སྲིང
ལྕྃ	ལྕམ
ལྕིགགུ	ལྕིག་གུ
ལྕིིག	ལྕིག་ལྕིག
ལྕིགྕིག	ལྕིག་ལྕིག
ལྕིཌ་	ལྕིགས་
ལྕིདྱིས	ལྕིད་ཀྱིས
ལྕུགུ	ལྕུག་གུ
ལྕུགྃ་	ལྕུག་མ་
ལྕུགུ	ལྕུག་གུ
ལྕུཌ་	ལྕུགས་
ལྕུཌ་	ལྕུགས་
ལྕུངཽྃ	ལྕུང་མོ
ལྕུཾ	ལྕུང
ལྕུཾ༹	ལྕུམ་རྩ
ལྕུྃརྩ་	ལྕུམ་རྩ་
ལྕུྃ	ལྕུམ
ལྕྖེུང	ལྕེ་ཆུང
ལྕེདེྃ	ལྕེ་མེད
ལྕེཚ	ལྕེ་ཚ
ལྕེརྩ	ལྕེ་རྩ
ལྕེརྩེ	ལྕེ་རྩེ
ལྕེབྱེད	ལྕེབ་བྱེད
ལྕོགེ༹	ལྕོག་ཙེ
ལྕཽག	ལྕོག་ལྕོག
ལྕོཌ་	ལྕོགས་
ལྕོངོ	ལྕོང་མོ
ལྗངལ	ལྗང་གསལ
ལྗངལ	ལྗང་གསལ
ལྗག	ལྗང་ནག
ལྗེར	ལྗང་སེར
ལྗནི	ལྗན་ལྗིན
ལྗཱབ	ལྗབ་ལྗབ
ལྗབི	ལྗབ་ལྗིབ
ལྟའི་	ལྟ་བའི་
ལྟུ	ལྟ་བུ
ལྟུའི	ལྟ་བུའི
ལྟུའོ་	ལྟ་བུའོ་
ལྟུས	ལྟ་བུས
ལྟྱེད	ལྟ་བྱེད
ལྷྲེ	ལྟ་འདེར
ལྟ	ལྟ
ལྟགཅོད	ལྟག་གཅོད
ལྟགི	ལྟག་ལྟིག
ལྟོར་	ལྟར་ངོ་
ལྟརླས	ལྟར་ལས
ལྟསྟེ	ལྟས་དེ
ལྟུར	ལྟུང་བར
ལྟེཾརེ	ལྟེམ་མེར
ལྟུའི	ལྟུ་བུའི
ལྟུངདཻ	ལྟུང་བྱེད་དེ
ལྟེབྃ	ལྟེབ་མ
ལྟཽསོ་	ལྟོ་གོས་སོ་
ལྟོའིངིཾ	ལྟོ་བའི་མིང
ལྟོསྃདེ	ལྟོས་མེད
ལྡབི	ལྡབ་ལྡིབ
ལྡབོ	ལྡབ་ལྡོབ
ལྡམུ	ལྡམ་ལྡུམ
ལྡརི	ལྡར་ལྡིར
ལྡིངྑང	ལྡིང་ཁང
ལྡུྃ་	ལྡུམ་
ལྡེྃགི	ལྡེ་མིག
ལྡེམེ་བ	ལྡེམ་མེ་བ
ལྡཻམ	ལྡེམ་ལྡེམ
ལྡེཾ	ལྡེམ
ལྡེཾསེ་ལྡེམ	ལྡེམས་སེ་ལྡེམ
ལྡོགརནྱས	ལྡོག་པར་གནས
ལྡོགླ་ཾསྲིུན	ལྡོག་ཟླ་མི་སྲུན
ལྡོགླ	ལྡོག་ཟླ
ལྡོབསྐྱེན་པ	ལྡོབས་སྐྱེན་པ
ལྷེན	ལྷ་གཤེན
ལྷེན	ལྷ་ཆེན
ལྷྲུག	ལྷ་དྲུག
ལྷ༹ཾས	ལྷ་མཚམས
ལྷཾས	ལྷ་མཚམས
ལྷིན	ལྷ་མིན
ལྷོཾ་དཔལུངན	ལྷ་མོ་དཔལ་ལུང་བསྟན
ལྷོཾ་ནོཾག	ལྷ་མོ་ནག་མོ
ལྷོཾ	ལྷ་མོ
ལྷཾཨོ	ལྷ་མོ
ལྷགོས	ལྷ་ཚོགས
ལྷོ༹གས	ལྷ་ཚོགས
ལྷོགས	ལྷ་ཚོགས
ལྷོ༹ཊ	ལྷ་ཚོགས
ལྷྲེའི	ལྷ་འདྲེའི
ལྷྲེ	ལྷ་འདྲེ
ལྷ༹ས	ལྷ་རྫས
ལྷནྡ	ལྷ་ལྡན
ལྷས	ལྷ་སྲས
ལྷིེནད	ལྷ་སྲིན་སྡེ་བརྒྱད
ལྷྲིནེད	ལྷ་སྲིན་སྡེ་བརྒྱད
ལྷྲིན	ལྷ་སྲིན
ལྷྲུང༌	ལྷ་སྲུང༌
ལྷགནས	ལྷག་གནས
ལྷགི	ལྷག་གི
ལྷགེ་བ	ལྷག་གེ་བ
ལྷགཾ	ལྷག་མ
ལྷགོ	ལྷག་ལྷོག
ལྷགྶོང	ལྷག་སོང
ལྷངེ	ལྷང་ངེ
ལྷེཾད	ལྷད་མེད
ལྷ༡	ལྷན་ཅིག
ལྷངེ༌	ལྷང་ངེ༌
ལྷངང༌	ལྷང་ལྷང༌
ལྷཱང	ལྷང་ལྷང
ལྷིག	ལྷན་གཅིག
ལྷནིག	ལྷན་ཅིག
ལྷིག	ལྷན་ཅིག
ལྷིནག	ལྷན་ཅིག
ལྷནེ	ལྷན་ནེ
ལྷནོ༹ཊ	ལྷན་ཚོགས
ལྷྱས	ལྷན་རྒྱས
ལྷྱེས	ལྷན་སྐྱེས
ལྷབུ	ལྷབ་ལྷུབ
ལྷམེ	ལྷམ་མེ
ལྷྃ	ལྷམ
ལྷསྐོས	ལྷས་བསྐོས
ལྷུགེར	ལྷུག་གེར
ལྷཱུག	ལྷུག་ལྷུག
ལྷུགལྃའི	ལྷུག་སྤེལ་མའི
ལྗེུངད	ལྷུང་བཐེད
ལྷུངེ༹ད	ལྷུང་བཟེད
ལྷྲིུབ	ལྷུན་གྱིས་གྲུབ
ལྷུནྲུབ	ལྷུན་གྲུབ
ལྷུབ	ལྷུན་གྲུབ
ལྷྲུབ	ལྷུན་གྲུབ
ལྷྲུནབ	ལྷུན་གྲུབ
ལྷུནོ	ལྷུན་པོ
ལྷུནོའིཛེྃ	ལྷུན་པོའི་མཛེས
ལྷུརླེན	ལྷུར་ལེན
ལྷཻབས	ལྷེབས་ལྷེབས
ལྷྱོིང	ལྷོ་གླིང
ལྷོུབདགོ	ལྷོ་ནུབ་བདག་པོ
ལྷོུབ	ལྷོ་ནུབ
ལྷཽཊོ	ལྷོ་ཕྱོགས་སོ
ལྷཽཊ	ལྷོ་ཕྱོགས
ལྷྱཽགས	ལྷོ་ཕྱོགས
ལྷྱོགས	ལྷོ་ཕྱོགས
ལྷྲཽད	ལྷོ་བགྲོད
ལྷྲོགརྫོང་	ལྷོ་བྲག་རྫོང་
ལྷོནོཾཌ	ལྷོ་མོན་ནགས
ལྷཽག	ལྷོག་ལྷོག
ཤྲགི༹ན	ཤ་ཁྲག་འཛིན
ཤྲག	ཤ་ཁྲག
ཤོྃ	ཤ་མོ
ཤཚིལ	ཤ་ཚིལ
ཤཁོན	ཤ་འཁོན
ཤྑོན	ཤ་འཁོན
ཤཱཀྱཐུབྶ	ཤཱཀྱ་ཐུབ་པ
ཤངོ	ཤང་ཤོང
ཤོད་	ཤད་དོ་
ཤནྱརཾ	ཤན་སྦྱར་མ
ཤབུ	ཤབ་ཤུབ
ཤཾབས	ཤམ་ཐབས
ཤམྦྷལང	ཤམྦྷ་ལ་དང
ཤཾ་བྷ་ལ	ཤམ་བྷ་ལ
ཤམྦྷ་ལ	ཤམ་བྷ་ལ
ཤཾ	ཤམ
ཤརྱི	ཤར་གྱི
ཤརགླིཾ	ཤར་གླིང
ཤིརྱང	ཤར་གླིང
ཤརོགས	ཤར་ཕྱོགས
ཤརོཊ	ཤར་ཕྱོགས
ཤརྒོས	ཤར་ཕྱོགས
ཤྱགོས	ཤར་ཕྱོགས
ཤྱོཊ	ཤར་ཕྱོགས
ཤརྃང	ཤར་མ་དང
ཤརི	ཤར་རི
ཤརྷོ	ཤར་ལྷོ
ཤྷོར	ཤར་ལྷོ
ཤརར	ཤར་ཤར
ཤརུ	ཤར་ཤུར
ཤརོ	ཤར་ཤོར
ཤིངྃ	ཤིང་ངམ
ཤིངེན	ཤིང་ཆེན
ཤིངྟོག	ཤིང་ཏོག
ཤིངྲནཚེརན	ཤིང་ཕྲན་ཚེར་ཅན
ཤིངཕྲནསྨན	ཤིང་ཕྲན་སྨན
ཤིངཁརསྱིལ	ཤིང་འཁར་གསིལ
ཤིངབྲསིལྙན	ཤིང་འབྲས་སིལ་སྙན
ཤིངབྱུག	ཤིང་འབྲུག
ཤིངཛིན	ཤིང་འཛིན
ཤིངརྟ	ཤིང་རྟ
ཤིངརྟའི	ཤིང་རྟའི
ཤིྃསོག	ཤིང་སོག
ཤིངནོ	ཤིང་སྔོན
ཤིངྶྟེ་	ཤིང་སྟེ་
ཤིནུ	ཤིན་ཏུ
ཤིནྟུ	ཤིན་ཏུ
ཤྟིུན	ཤིན་ཏུ
ཤི༹ས	ཤིས་མཛད
ཤུགསོཾ	ཤུག་གསོམ
ཤུཌ	ཤུགས
ཤུབུར་སྨྲ་བ	ཤུབ་བུར་སྨྲ་བ
ཤཱུམ་པ	ཤུམ་ཤུམ་པ
ཤུལྖེནང	ཤུལ་ཆེན་དང
ཤུལཾ	ཤུལ་ལམ
ཤེདག	ཤེད་བདག
ཤེདུ	ཤེད་བུ
ཤེརིནཾ	ཤེར་ཕྱིན་མ
ཤེརིན་མཆོདེན	ཤེར་ཕྱིན་མཆོད་རྟེན
ཤེརིན	ཤེར་ཕྱིན
ཤེརྱིན	ཤེར་ཕྱིན
ཤེལན	ཤེལ་ཅན
ཤེསྱ	ཤེས་བྱ
ཤྱེ	ཤེས་བྱ
ཤྱེས	ཤེས་བྱ
ཤེསྱེད	ཤེས་བྱེད
ཤེསའི	ཤེས་པའི
ཤེསཚོར	ཤེས་ཚོར
ཤེརྱིན་པ	ཤེས་རབ་ཀྱི་ཕ་རོལ་ཏུ་ཕྱིན་པ
ཤྲེབྱིས	ཤེས་རབ་ཀྱིས
ཤྲེབངྶྐུར	ཤེས་རབ་དབང་བསྐུར
ཤྲེབསྣཾསངེསརྙེད	ཤེས་རབ་བསམས་ནས་ངེས་རྙེད
ཤེརྲི	ཤེས་རབ་རལ་གྲི
ཤེབ	ཤེས་རབ
ཤེསབ	ཤེས་རབ
ཤྲེབ	ཤེས་རབ
ཤྲེབ	ཤེས་རབ
ཤེསྲིག	ཤེས་རིག
ཤེསྡན	ཤེས་ལྡན
ཤེསོ	ཤེས་སོ
ཤེསོང	ཤེས་སོང
ཤེསླ	ཤེས་སླ
ཤོགུ	ཤོག་གུ
ཤོགྦུ	ཤོག་བུ
ཤོདུ	ཤོད་དུ
ཤཽར	ཤོར་རོ
ས་པཎ	ས་ཀྱ་པཎྜིཏ
སྑུལ	ས་ཁུལ
སཁོངསུ	ས་ཁོངས་སུ
སཁྲའདྲའོ་	ས་ཁྲ་འདྲའོ་
སདན	ས་གདན
སནྱྃ་	ས་གནམ་
སཞྱིའིངཾ	ས་གཞིའི་མིང
ས་གནམ	ས་གཞི་དང་གནམ་ག
སྒེ་སོགེ	ས་གེ་སོག་གེ
སངོས	ས་ངོས
སཔགཚད་	ས་དཔག་ཚད་
སཔྱདཁཾ	ས་དཔྱད་ཁང
སབྱིབས	ས་དབྱིབས
སཀྲ	ས་བཀྲ
སཅད	ས་བཅད
སཅུའོ་	ས་བཅུའོ་
སཌ	ས་བདག
སབབ	ས་བབ
སྦེ་སིབེ་	ས་བེ་སིབ་བེ་
སྦེ་སོབེ་	ས་བེ་སོབ་བེ་
སོན	ས་བོན
སྦོན	ས་བོན
སབླ་	ས་བླ་
སྃཐའྃཐའ	ས་མཐའ་མཐའ
སདྃའ	ས་མདའ
སི༹ཊ	ས་ཚིགས
སྃཚམས	ས་མཚམས
སཚིཌ	ས་ཚིགས
སྮིངཟོས	ས་ཞིང་བཟོས
སྮེས	ས་ཞེས
སགུལསཆ	ས་འགུལ་ས་ཆ
སདྃམོ	ས་འདམ་མོ
སི༹ན	ས་འཛིན
སའོག	ས་འོག
ས་ཡའབྃ	ས་ཡ་འབུམ
ས་རེསོརེ	ས་རེ་སོར་རེ
སྱུས	ས་རྒྱུས
སླཱ	སཱ་ལ
ས་ལུ	ས་ལུ་
སསྐྱ་	ས་སྐྱ་
སྐྱ	ས་སྐྱ
སསྟེང	ས་སྟེང
སྟེང	ས་སྟེང
སསྲིན	ས་སྲིན
སསློགྲྡོ་	ས་སློག་རྡོ་
སགྙ	སག་ཉ
སགྮྭ	སག་ཞྭ
སགྲི་	སག་རི་
སགྲིསན	སག་རིས་ཅན
སགྡར	སག་རྡར
སགྷྃ	སག་ལྷམ
སཱང་པོ	སང་སང་པོ
སཾསང	སངས་དང
སངྱསྱི	སངས་རྒྱས་ཀྱི
སངྱསྱིས	སངས་རྒྱས་ཀྱིས
སདྱསྃད	སངས་རྒྱས་ཐམས་ཅད
སངྱས་འབྲསུ	སངས་རྒྱས་འབྲས་བུ
སདྱསྃ	སངས་རྒྱས་སམ
སདྱསོ	སངས་རྒྱས་སོ
སངྱསྐྱོངཀྱིསཛ༹དའི	སངས་རྒྱས་སྐྱོངས་ཀྱིས་མཛད་པའི
སདྱསྲསྱིསྐོར	སངས་རྒྱས་སྲས་ཀྱིས་བསྐོར
སངྱས	སངས་རྒྱས
སརྒྱས	སངས་རྒྱས
སྔྱས	སངས་རྒྱས
སདྱཾས	སངས་རྒྱས
སདྱས	སངས་རྒྱས
སདྱས	སངས་རྒྱས
སཾས	སངས
སདང	སད་དང
སདརྃདོ	སད་པར་མེད
སདར	སད་པར
སདདྱབ	སད་བརྒྱབ
སདཚེ་	སད་ཚེ་
སདལྷུཾ	སད་ལྷུང
སདྶུདཙྃ་	སད་སུད་ཙམ་
སདྶུད	སད་སུད
སདྶེར	སད་སེར
སབྣི་	སབ་ནི་
སབེ་	སབ་བེ་
སབྶོབྃ	སབ་སོབ་བམ
གླིཾཅུསིེ་	སམ་གླིང་བཅུ་གཉིས་ཏེ་
སྃདྕིལཌ་	སམ་ཅི་ལགས་
སྃ	སམ
སའིཁྃསྃབྱུང	སའི་ཁམས་སམ་འབྱུང
སའིགོ	སའི་གོ
སའིདགོ་	སའི་བདག་པོ་
སརོརང	སར་སོར་དང
སལྶིལེར	སལ་སིལ་རེ
སྶུལ	སལ་སུལ
སལྶིལ	སལྶིལ
སི་ཏཆོུ་	སི་ཏ་ཆུ་བོ་
སྲིིལ	སི་རིལ
སྒྲི་	སི་སྒྲ་
སིགི	སིག་སིག
སིཌྃ་	སིགས་མ་
སིཌིག	སིགས་ཤིག
སོངྒ	སིང་ག
སིངེ་	སིང་ངེ་
སིངིང	སིང་སིང
སིཾསོ་	སིངས་པོ་
སིངསླགིྃརྩྱང	སིངས་རླག་མི་གཅང
སྶྒྲི	སིད་སྒྲ
སིནྡྷུ	སིནྡྷུ
སིབྣད	སིབ་ནད
སིབུ	སིབ་བུ
སིབིབ	སིབ་སིབ
སིྃ	སིམ
སིལྑྲོལ	སིལ་ཁྲོལ
སིལྟོགྃ	སིལ་ཏོག་གམ
སིལྟོག	སིལ་ཏོག
སིལོཚཌ	སིལ་ཚོང
སིལིལཀྲོལའིསྒྲ	སིལ་སིལ་དཀྲོལ་བའི་སྒྲ
སཱིལ	སིལ་སིལ
སིལྒྲ	སིལ་སྒྲ
སུཅདའྡིེ	སུ་བཅད་པའི་སྡེ
སུམུ	སུ་མུ
སུའོངསུསཤད	སུ་འོངས་སུས་བཤད
སུརེད	སུ་རེད
སུགྠིང	སུག་ཏིའང
སུགྲིས	སུག་བྲིས
སུགྨེལ	སུག་མེལ
སུགླས	སུག་ལས
སུགྶྨེལདྲ	སུག་སྨེལ་འདྲ
སུགྨེལ	སུག་སྨེལ
སུཾསུཾས	སུང་སུངས
སུནབྱུང	སུན་དབྱུང
སུནོ་	སུན་པོ་
སུནཕྱིུང	སུན་ཕྱུང་ཞིང
སུནཕྱུངསིག	སུན་ཕྱུངས་ཤིག
སིུན	སུན་འབྱིན
སུནབྱིན	སུན་འབྱིན
སུནྣང	སུན་སྣང
སུབྼི	སུབ་བྲི
སུབསིགྥྲིས	སུབས་ཤིག་ཕྲིས
སུྃཁྲི	སུམ་ཁྲི
སུམྱོན	སུམ་གྱིན
སུྃཅུ	སུམ་ཅུ
སིུཆའོ་	སུམ་ཆའོ་
སུྃདདསུྃསྟོང	སུམ་བརྒྱ་སུམ་སྟོང
སུཾ་བངྱ	སུམ་བརྒྱ
སུཾ་བརྒྱ	སུམ་བརྒྱ
སེུ༹ཊ	སུམ་བརྩེགས
སུམྕོུང	སུམ་མེ་ཅུང
སུམདོ	སུམ་མདོ
སུཾདོ	སུམ་མདོ
སུྃབུྃ	སུམ་འབུམ
སུྃརྐྱ་	སུམ་རྐྱ་
སུྃརྟཌ	སུམ་རྟགས
སུམེ༹ན	སུམ་རྩེན
སྱྃསྒྲིལ	སུམ་སྒྲིལ
སུྃ	སུམ
སུྃསིག	སུམས་ཤིག
སུའིཟེར	སུའི་ཟེར
སུལང	སུལ་དང
སུལྱུག	སུལ་དྲུག
སུལྃང	སུལ་མང
སུལོྃ་	སུལ་མོ་
སུལཾ	སུལ་ལམ
སུསཤད	སུས་བཤད་
སུསིགལྲོནང	སུས་ཤིག་མགྲོན་དང
སེོ	སེ་བོ་
སྦེོ	སེ་བོ་
སེོྃ	སེ་མོ་
སླེ	སེ་འབྲུ
སྱོབ	སེ་ཡབ
སྱེོ	སེ་ཡོ
སྲེལྱས	སེ་རལ་བྱས
སྲེལ	སེ་རལ
སྲེུལ	སེ་རུལ
སཻགརྡར	སེག་སེག་རྡར
སེངེན	སེང་གེ་ཅན
སེངེ་བཟངོས་མ༹དའི	སེང་གེ་བཟང་པོས་མཛད་པའི
སེངེ༌	སེང་གེ
སེངྒེ	སེང་གེ
སཻང	སེང་གེ
སཻངྒའྃཡུ	སེང་གེའི་གཡུ
སཻངའིངར	སེང་གེའི་ངར
སེངནེ	སེང་ཆེན
སེངཕྲོྃ	སེང་ཕྲོམ་
སེངྃ	སེང་མ
སེངྡེང	སེང་ལྡེང
སྷཻང	སེང་ལྡེང
སེནོྃ	སེན་མོ
སེནོྃ	སེན་མོ
སེྃནྃད	སེམས་ཅན་ཐམས་ཅད
སེནཾད	སེམས་ཅན་ཐམས་ཅད
སེནཾདཾ	སེམས་ཅན་ཐམས་ཅད
སེཾནཐཾད	སེམས་ཅན་ཐམས་ཅད
སེཾན་བླུནོ	སེམས་ཅན་བླུན་པོ
སེན	སེམས་ཅན
སེནཾ	སེམས་ཅན
སེཾན	སེམས་ཅན
སེཾཨན	སེམས་ཅན
སེཾསེན	སེམས་ཆེན
སེསྖུྃང	སེམས་ཆུང
སེཾསིད	སེམས་ཉིད
སེདྃའོ་	སེམས་དཔའ་འོ་
སྃདེའ	སེམས་དཔའ
སེདྃའ	སེམས་དཔའ
སེདའཾ	སེམས་དཔའ
སེཾདའ	སེམས་དཔའ
སེཾའ	སེམས་དཔའ
སེཾསའི	སེམས་པའི
སེྃདའི	སེམས་དཔའི
སྐྱཻྃདངོ་	སེམས་བསྐྱེད་དང་པོ་
སེསྐྱཻད	སེམས་བསྐྱེད་དེ
སེཾསྐྱེད	སེམས་བསྐྱེད
སེསྐྱཾདེ	སེམས་བསྐྱེད
སེསྐྱེྃད	སེམས་བསྐྱེད
སེསྱུྃང	སེམས་བྱུང
སེྃསྑྲལིྃ་	སེམས་འཁྲལ་མི་
སཻཾ༹ར	སེམས་འཚེར
སེྃསཛིན	སེམས་འཛིན
སེྃསླས	སེམས་ལས
སེཾསུ	སེམས་སུ
སེསུྃ	སེམས་སུ
སེསྐྱིྃད	སེམས་སྐྱིད
སེྃསྐྱེད	སེམས་སྐྱེད་དེ
སེཾསྐྱེས	སེམས་སྐྱེས
སེྃསྙིངེ་	སེམས་སྙིང་རྗེ་
སེཾསྡུག	སེམས་སྡུག
སེཾསྲོངོ	སེམས་སྲོང་བོ
སྃསེ	སེམས
སེྃས	སེམས
སེསཾ	སེམས
སྶེ	སེམས
སེཾས	སེམས
སེརྒ	སེར་ག
སེརེན	སེར་ཆེན
སེརྃར	སེར་དམར
སེརགཾ	སེར་ནག་མ
སེརག	སེར་ནག
སེརོ	སེར་པོ
སོེར	སེར་པོ
སེརྦ	སེར་བ
སེརཽཁ	སེར་བོ་རོ་ཁ
སེརོ་	སེར་བོ
སེརའོི་	སེར་བོའི་
སེརོྃ་	སེར་མོ
སེརྴ	སེར་ཤ
སཻར	སེར་སེར
སེརྐྱ	སེར་སྐྱ
སྣེརན	སེར་སྣ་ཅན
སེརྣེ་	སེར་སྣ་ཆེ་
སེརྣྃདེ་	སེར་སྣ་མེད
སྣེར	སེར་སྣ
སེལརྱེད	སེལ་བར་བྱེད
སེལྱོང	སེལ་བོ་ཡང
སེལོ	སེལ་བོ
སྐོ་	སོ་ཀ་
སྕོན	སོ་ཅན
སྠོར	སོ་ཐར
སོང	སོ་དང
སྲོུག	སོ་དྲུག
སྥོགསྲོཌྯིན	སོ་ཕག་བསྲེགས་ཟིན
སྦོ་	སོ་བ་
སོཏངསྲོཌ	སོ་བཏང་བསྲེགས
སོཞི	སོ་བཞི
སྱོ་	སོ་བྱ་
སོའརོ་	སོ་འཁོར་
སྙོལྣི	སོ་རྙིལ་ན
སཽབ	སོ་སོ་བ
སོོབ	སོ་སོ་བ
སཽ	སོ་སོ
སཽའི	སོ་སོའི
སཽར	སོ་སོར
སྲོུང	སོ་སྲུང
སྲོུབྣས	སོ་སྲུབས་ནས
སོགྕིག	སོག་ཅིག
སོགྣང	སོག་ནང
སོགྶ	སོག་པ
སོགྶོ་	སོག་པོ་
སོགྱིལྶྣདྱན	སོག་བྱིལ་རྣ་རྒྱན
སོགྲོྃ་	སོག་མ་གྲོ་
སོགྲུསོགྶྐ་	སོག་རུས་སོག་སྐད
སོགླེང	སོག་ལེ་དང
སོགེ	སོག་ལེ
སོགྱོིག	སོག་སོག་ཡིག
སཽག	སོག་སོག
སོཌཀྱིསླསའི་	སོགས་ཀྱིས་སླས་པའི་
སོགསུངས	སོགས་སུ་གསུངས་པ
སོཌ	སོགས
སོཊ	སོགས
སོཌ	སོགས
སྦོང	སོང་བ
སོངྃག	སོང་ཞིག
སཽངང	སོང་སོང
སོངསིག	སོངས་ཤིག
སོན་འདེས	སོན་འདེབས
སོནྲུ	སོན་འབྲུ
སོབྣ་	སོབ་ན
སོབྦེས	སོབ་བེས
སོབོ	སོབ་སོབ
སོབསསིག	སོབས་ཤིག
སོཾ	སོམ་
སོཾསིགུ	སོམས་ཤི་གུ
སོཾས་ཤིག	སོམས་ཤིག
སོསཾ་ཤིག	སོམས་ཤིག
སོཾས	སོམས
སོརཟགྶོར	སོར་བཞག་སོར
སོརོཾ་	སོར་མོ་
སཽྃ	སོར་མོ
སོརྒང	སོར་སོར་གང
སོལྦྱས	སོལ་བྱས
སསྐོའོ་	སོས་ཀའོ་
སོསྐར	སོས་ཀར
སོསྡལྡད	སོས་དལ་བསྡད
སོསྡདྯིན	སོས་བལྡད་ཟིན
སོསྡོད	སོས་བལྡད
སོསོ	སོས་སོ
སྐདྕིགྃའི	སྐད་ཅིག་མའི
སྐདིག	སྐད་ཅིག
སྐིག	སྐད་ཅིག
སྐིདག	སྐད་ཅིག
སྐདོ	སྐད་དོད
སྐབསུཾ	སྐབས་གསུམ
སྱྐྲོེེདམ	སྐབས་འགྲོ་སེམས་བསྐྱེད
སྐབོ༹ལ	སྐབས་འཚོལ
སྐབསུ	སྐབས་སུ
སྐབསུ	སྐབས་སུ
སྐམིན	སྐམ་མིན
སྐྃ	སྐམ
སྐཾར	སྐར་མ
སྐརྨ	སྐར་མ
སྐཾའ	སྐར་མདའ
སྐལད	སྐལ་ཆད
བསྐང༌	སྐལ་བཟང༌
སྐལྯང	སྐལ་བཟང
སྐ༹ང༌	སྐལ་བཟང༌
སྐང༌	སྐལ་བཟང༌
སྐལང༌	སྐལ་བཟང༌
སྐལ༹ང	སྐལ་བཟང
སྐལྡན	སྐལ་ལྡན
སྐུགས	སྐུ་གསུང་ཐུགས
སྐུངགས	སྐུ་གསུང་ཐུགས
སྐུངཊ	སྐུ་གསུང་ཐུགས
སྐུྃཉེལ	སྐུ་མཉེལ
སྐུཾན	སྐུ་མདུན
སྐུདོག	སྐུ་མདོག
སྐོུག	སྐུ་མདོག
སྐེུ༹	སྐུ་ཚེ
སྐུར	སྐུ་འདྲ
སྐོུད	སྐུ་སྟོད
སྐུད	སྐུ་སྨད
སྐུདཕངསྱིར	སྐུད་འཕང་གསིར་
སྐུལྱེད་མ	སྐུལ་བྱེད་མ
སྐུལྱེད	སྐུལ་བྱེད
སྐོརཉྱེནའོར	སྐོར་གཉེན་འཁོར
སྐྱཾའ	སྐྱ་མདའ
སྐྱྱ	སྐྱ་སྐྱ
སྐྱོཾན	སྐྱབས་མགོན
སྐྱགྲོམེདེ	སྐྱབས་འགྲོ་སེམས་བསྐྱེད
སྐྱབསུ་མཆི	སྐྱབས་སུ་མཆི
སྐྱབསོ	སྐྱབས་སོ
སྐྱི་ོཾ	སྐྱི་མོ་
སྐྱིདོ	སྐྱིད་དོ
སྐྱིདོ	སྐྱིད་པོ
སྐྱིུང༌	སྐྱིལ་དཀྲུང༌
སྐྱུཾས	སྐྱུངས
སྐྱུརོ	སྐྱུར་རོ
སྐྱེུ	སྐྱེ་དགུ
སྐྱེའི་	སྐྱེ་བའི་
སྐྱཻ	སྐྱེ་བོ
སྐྱེོ་	སྐྱེ་བོ་
སྐྱཻད	སྐྱེ་མཆེད
སྐྱེདེ	སྐྱེ་མཆེད
སྐྱཻད	སྐྱེ་མེད
སྐྱེེད	སྐྱེ་མེད
སྐྱེརོ	སྐྱེ་འགྲོ
སྐྱོེ	སྐྱེ་འགྲོ
སྐྱྲོེ	སྐྱེ་འགྲོ
སྐྱེུ	སྐྱེ་རྒུ
སྐྱེདེ	སྐྱེ་སྲེད
སྐྱེདཾ	སྐྱེད་མ
སྐྱེདོ༹ལ	སྐྱེད་མོས་ཚལ
སྐྱེད༹ལ	སྐྱེད་ཚལ
ལྐྱེལྱི	སྐྱེལ་གྱི
སྐྱིུང	སྐྱེལ་དཀྲུང
སྐྱེནཾ	སྐྱེལ་མཁན
སྐྱེསྱིྃ་	སྐྱེས་ཁྱིམ་
སྐྱེསྟེ	སྐྱེས་ཏེ
སྐྱེསའི	སྐྱེས་པའི
སྐྱེསུ	སྐྱེས་བུ
སྐྱེསུ་བསྐུར	སྐྱེས་སུ་བསྐུར
སྐྱེསུ	སྐྱེས་སུ
སྐྱེསོ	སྐྱེས་སོ
སྐྱོསེ	སྐྱོ་ཤེས
སྐྱོེས	སྐྱོ་ཤེས
སྐྱོཌ་	སྐྱོགས་
སྐྱོན༣སྤངསྟེ	སྐྱོན་གསུམ་སྤངས་ཏེ
སྐྱོནདོ	སྐྱོན་བརྗོད
སྐྱོནྲལ	སྐྱོན་བྲལ
སྐྱཽན	སྐྱོན་ཡོན
སྒྃ	སྒམ
སྒུུར	སྒུར་སྒུར
སྒོ་དྲུགི་གཟུངས	སྒོ་དྲུག་གི་གཟུངས
སྒོ་དྲུགིཟུངས	སྒོ་དྲུག་གི་གཟུངས
སྒོ་མཐའསྲུངས	སྒོ་མཐའ་ཡས་གཟུངས
སྒྱོདེ	སྒོ་འབྱེད
སྒོ	སྒོ
སྒོྃ་	སྒོམ་
སྒོརོཾ	སྒོར་མོ
སྒྱུཾན	སྒྱུ་མ་མཁན
སྒྱུལ	སྒྱུ་འཕྲུལ
སྒྱུ༹ལ	སྒྱུ་རྩལ
ངྱུར་བ	སྒྱུར་བ
ངྱུར་བ	སྒྱུར་བ
སྒྲནྱིས	སྒྲ་གཅན་གྱིས
སྒྲཅྱནྃངེ་	སྒྲ་གཅན་མིང་
སྒྲན	སྒྲ་གཅན
སྒྲྶྟེ་	སྒྲ་སྟེ་
སྒླ	སྒྲ་བླ
གྲླ	སྒྲ་བླ
སྒླ	སྒྲ་ཟླ
སྒྲཽཊ	སྒྲ་འདོགས
སྒྲགསོ	སྒྲགས་སོ
སྒྲགསོ	སྒྲགས་སོ
སརྒཌ	སྒྲགས
སྒྲོགྃཉྃཇོགིཟུཌན	སྒྲིག་མཉམ་འཇོག་གི་གཟུགས་ཅན
སྒྲིབྱེད	སྒྲིབ་བྱེད
སྒྲིཾགོས	སྒྲིམ་དགོས
སྒྲཽགས	སྒྲོ་འདོགས
སྒྲོགསུ	སྒྲོགས་སུ
སྒྲོཾན	སྒྲོན་མ
སྒྲོྃ	སྒྲོམ
སྒྲོལྱེད	སྒྲོལ་བྱེད
སྒྲོཾལ	སྒྲོལ་མ
སྔཊ	སྔགས
སྔཌ་	སྔགས་
སྔཌ	སྔགས
སྲརཁྲིཾསསྟར	སྔར་ཁྲིམས་ལྟར
སྔསུ	སྔས་སུ
སྔུར	སྔུར
སྔཽ	སྔོ་སྔོ
སྔོནྱི	སྔོན་གྱི
སྔོིནྱ	སྔོན་གྱི
སྔོནད	སྔོན་ཆད
སྔོནུ	སྔོན་དུ
སྔཽན	སྔོན་པོ
སྔོནོ	སྔོན་པོ
སྣཽན	སྔོན་པོ
སྔོནུ	སྔོན་བུ
སྔོནེ༹	སྔོན་ཚེ
སྔོནྲོ	སྔོན་འགྲོ
སྔོཨཽནྲ	སྔོན་འགྲོ
སྙགིས	སྙགས་སྙིགས
སྙློ	སྙ་ལོ
སྙཌ་	སྙགས་
སྙོཾཌ་	སྙང་སྙོགས་
སྙདཙོས	སྙད་གཙེས
སྙདཏཌ་	སྙད་བཏགས་
སྙདརྐོ	སྙད་བརྐོ
སྙྃདེད	སྙད་མེད
སྙདོཌ་	སྙད་འདོགས་
སྙདཛུཌ་	སྙད་འཛུགས་
སྙནྐོར	སྙན་ཀོར
སྙནྑུང	སྙན་ཁུང
སྙནཙེརྃནི	སྙན་གཙེར་མིན
སྙནསྱནབེབ	སྙན་གསན་འབེབས
སྙནསྱལྷོནེརསྱན	སྙན་གསོལ་ལྷན་ནེར་གསན
སྙནྱི	སྙན་གྱི
སྙནཾག	སྙན་ངག
སྣནཾག	སྙན་ངག
སྙནཾཌ་	སྙན་དངགས་
སྙནབང་	སྙན་དབང་
སྙནུ	སྙན་དུ
སྙནོ	སྙན་ནོ
སྙནར	སྙན་པར
སྙནྲ	སྙན་ཕྲ
སྙནྱུད	སྙན་བརྒྱུད
སྙནསྐུལ	སྙན་བསྐུལ
སྙནོྃ	སྙན་མོ
སྙནཚིགི	སྙན་ཚིག་གི
སྙནཚིག	སྙན་ཚིག
སྙནྮུ	སྙན་ཞུ
སྙནཇོབས	སྙན་འཇེབས
སྙནྲིན	སྙན་འཕྲིན
སྙནབུལརྩེཟྱི	སྙན་འབུལ་བརྩེ་གཟིགས
སྙནད	སྙན་རྒྱུད
སྙནལཕྱང་	སྙན་ཤལ་འཕྱང་
སྙནལ	སྙན་ཤལ
སྙྲོན	སྙན་སྒྲོན
སྙཾ་པའི	སྙམ་པའི
སྙཾམཾ	སྙམ་མམ
སྙམེ	སྙམ་མེ
སྙོཾ	སྙམ་མོ
སྙྃ	སྙམ
སྣཾས	སྙམས
སྙལྱིནདུག	སྙལ་གྱིན་འདུག
སྙིོྃ	སྙི་མོ
སྙིཁནི	སྙིག་མཁན་ནི
སྙིཌ་	སྙིགས་
སྙིཌའོྃ	སྙིགས་མའོ་
སྙིངྑ	སྙིང་ཁ
སྙིྃཁྃསྕན	སྙིང་ཁམས་ཅན
སྙིངར	སྙིང་ཁར
སྙྐིུང	སྙིང་ཁུང
སྙིངོ་	སྙིང་ཁོང་
སྙྲིཾག	སྙིང་ཁྲག
སྙིངྑྲག	སྙིང་ཁྲག
སྙིངྒ་	སྙིང་ག
སྙིངཅྱེསྙིང	སྙིང་གཅེས་སྙིང
སྙིངའིརྩ་	སྙིང་གའི་རྩ་
སྙིངའི	སྙིང་གའི
སྙིངར	སྙིང་གར
སྙིངྒི	སྙིང་གི
སྙིཾཐིགྻང	སྙིང་ཐིག་ཡང
སྙིངིག	སྙིང་ཐིག
སྙིཾཀར	སྙིང་དཀར
སྙིངུབབ	སྙིང་དུ་འབབ
སྙིངུ	སྙིང་དུ
སྙིཾནོར	སྙིང་ནོར
སྙིངོ	སྙིང་པོ
སྙོིང	སྙིང་པོ
སྙིནོ	སྙིང་པོ
ཉེདང	སྙེད་དང
སྙེཾས	སྙེམས
སྙིངརྩེའི	སྙིང་བརྩེ་བའི
སྙིངསྟན	སྙིང་བསྟན
སྙིངོེ་	སྙིང་བོ་ཆེ་
སྙིངོྃདེ	སྙིང་བོ་མེད
སྙིངོ	སྙིང་བོ
སྙིངོའི	སྙིང་བོའི
སྙིངོར	སྙིང་བོར
སྙིངོས	སྙིང་བོས
སྙིངྃདེ	སྙིང་མེད
སྙིངཚ	སྙིང་ཚ
སྙིངཚད	སྙིང་ཚད
སྙིངཚབ	སྙིང་ཚབ
སྙིངིྃ་	སྙིང་ཚིམ་
སྙིངཚིལ	སྙིང་ཚིལ
སྙིངྮོ་	སྙིང་ཞོ་
སྙིངགུལྙིངྕན	སྙིང་འགུལ་སྙིངཅན
སྙིངཚུབ	སྙིང་འཚུབ
སྙིངཻ༌	སྙིང་རེ་རྗེ
སྙིེེང	སྙིང་རེ་རྗེ
སྙིངེེའྃ	སྙིང་རེ་རྗེའམ
སྙིངརྗེཚདྃདེ	སྙིང་རྗེ་ཚད་མེད
སྙིངེེ	སྙིང་རྗེ་རྗེ
སྙིངེ	སྙིང་རྗེ
སྙིེང	སྙིང་རྗེ
སྙིངེས	སྙིང་རྗེས
སྙིངརྩ	སྙིང་རྩ
སྙིཾསྡུག	སྙིང་སྡུག
སྙིཾ	སྙིང
སྙུགུ	སྙུག་གུ
སྙོངོས	སྙོན་མོངས
སྙོེྃ	སྙོམ་མེ
སྙོུྃརག	སྙོམས་པར་འཇུག
སྙོཾསཇུག	སྙོམས་འཇུག
སྙོྃས	སྙོམས
སྟགཟིག	སྟག་གཟིག
སྟགི་ལོ	སྟག་གི་རོ
སྟགྱོས	སྟག་མྱོས
སྟྱོས	སྟག་སྨྱོས
སྟངསྟབས	སྟངས་སྟབས
སྟཱབ་པོ	སྟབ་སྟབ་པོ
སྟུགོཉིད	སྟུག་པོ་གཉིད
སྟེདྲ	སྟེ་འདྲ
སྟེསེར	སྟེ་སེར
སྟེོནའི	སྟེ་སྟོན་པའི
སྟེཌ་	སྟེགས་
སྟོངེན	སྟོང་ཆེན
སྟོངདིང་	སྟོང་ཉིད་དང་
སྟོངིད	སྟོང་ཉིད
སྟོིངད	སྟོང་ཉིད
སྟོངང	སྟོང་དང
སྟོངུ	སྟོང་དུ
སྟོངག	སྟོང་ཕྲག
སྟོཨུང	སྟོང་རྒྱུང
སྟོདཡྱོཌ་	སྟོད་གཡོགས་
སྟོདུལ	སྟོད་འདུལ
སྟོནཾ	སྟོན་ནམ
སྟོནས	སྟོན་ནས
སྟོནར	སྟོན་པར
སྟོནྱོཌ་	སྟོན་ཕྱོགས་
སྟོབྱས	སྟོབས་རྒྱས
སྟོབསྱིརྩ་	སྟོབས་ཀྱི་རྩ་
སྟོསྕན	སྟོབས་ཅན
སྟོབྴུཌ་	སྟོབས་ཤུགས་
སྟོབསཌོ་	སྟོབས་སོགས་
སྟོབསྙིངེེ་	སྟོབས་སྙིང་རྗེ་རྗེ་
སྡྲིབི	སྡིག་སྒྲིབ
སྡིན	སྡིག་སྲིན
སྡྲིིན	སྡིག་སྲིན
སྡིུ༹བ	སྡིགས་མཛུབ
སྡིུབ	སྡིགས་མཛུབ
སྡུགུ	སྡུག་གུ
སྡུགེ་བ	སྡུག་གེ་བ
བསྡུལ	སྡུག་བསྔལ
སྡུགལ	སྡུག་བསྔལ
སྡུཾལ	སྡུག་བསྔལ
སྡུལ	སྡུག་བསྔལ
དུགྔལ	སྡུག་བསྔལ
སྡུགྟུསྱིསློབ	སྡུག་རུས་ཀྱིས་སློབ
སྡུགསྐྱེས	སྡུག་སྐྱེས
སྡེུད	སྡུད་དེ
སྡུདདྱྃསུལིང	སྡུད་བརྒྱ་མ་སུལ་མང
སྡྲེུག	སྡེ་དྲུག
སྡེཚནསྐབསཾཁེན	སྡེ་བཙན་སྐབས་མཁན་ཆེན
སྔྱེད	སྡེ་བརྒྱད
སྡྱེད	སྡེ་བརྒྱད
སྡེ༹ན	སྡེ་ཚན
སྡོཚན	སྡེ་ཚན
སྡེདོང	སྡེ་སྣོད་དང
སྡེབྱོར	སྡེབ་སྦྱོར
སྡེརོཾ	སྡེར་མོ
སྡྲཽགས༹ད	སྡོང་གྲོགས་མཛད
སྡྲོངོ༹ད	སྡོང་གྲོགས་མཛད
སྡྲཽགས	སྡོང་གྲོགས
སྡྲོངོཊ	སྡོང་གྲོགས
སྡཽང༌	སྡོང་པོ
སྡོངོའི་	སྡོང་བོའི་
སྡོཾ་གསུཾ	སྡོམ་གསུམ
སྡོྃའི	སྡོམ་པའི
སྡཽཾ་	སྡོམ་མོ་
སྡོཾ༹གི	སྡོམ་ཚིག
སྡོཾ	སྡོམ
སྣནེ	སྣ་ཆེན
སྣ་ཚོགསྡེ	སྣ་ཚོགས་སྡེ
སྣ༹གོསྡེ	སྣ་ཚོགས་སྡེ
སྣ༹གོས	སྣ་ཚོགས
སྣོ༹གས	སྣ་ཚོགས
སྣོག༹ས	སྣ་ཚོགས
སྣོ༹ཊ	སྣ་ཚོགས
སྣྲོགས	སྣ་ཚོགས
སྣྲོཊ	སྣ་ཚོགས
སྣཚོཌ	སྣ་ཚོགས
སྣོ༹གས	སྣ་ཚོགས
སྣོ༹ཌ	སྣ་ཚོགས
སྣགྦུྃ	སྣག་བུམ
སྣག་ཤོག	སྣག་ཚ་དང་ཤོག་བུ
སྣག་སྨྱུག	སྣག་ཚ་དང་སྨྱུག་གུ
སྣངལ	སྣང་གསལ
སྣངསྱལ	སྣང་གསལ
སྣངོ	སྣང་ངོ
སྣངྃཛད	སྣང་མཛད
སྣངུ	སྣང་ངུ
སྣངོར	སྣང་ངོར
སྣང་མུན	སྣང་བ་དང་མུན་པ
སྣངཚུལ	སྣང་ཚུལ
སྣང་རྟོགི	སྣང་རྟོག་གི
སྣངིད	སྣང་སྲིད
སྣྲིངད	སྣང་སྲིད
སྣྲིངད	སྣང་སྲིད
སྣམུ	སྣམ་བུ
སྣཾ	སྣམ
སྣརྨ	སྣར་མ
སྙིངོ་	སྣིང་བོ་
སྣུབའི	སྣུབ་པའི
སྣེང་	སྣེ་དང
སྣེའིར	སྣེའི་བར
སྣོགཟན	སྣོག་གཟན
དསནོདྱི་	སྣོད་ཀྱི་
སྣོུད	སྣོད་བཅུད
སྤངསའི	སྤངས་པའི
སྤྲིུ	སྤུ་གྲི
སྤུན༣	སྤུན་གསུམ
སྤྕུནོ	སྤུན་ཅན་ནོ
སྤུནླ	སྤུན་ཟླ
སྤེལྱེད	སྤེལ་བྱེད
སྤེལཾ	སྤེལ་མ
སྤེལོ	སྤེལ་ལོ་
སྤོསཾགི	སྤོངས་ཤིག
སྤོབའི་བླཽས	སྤོབས་པའི་བློ་གྲོས
སྤོབྮན	སྤོབས་ཞན
སྤོསྱི	སྤོས་ཀྱི
སྤོསཀརཤིང	སྤོས་དཀར་ཤིང
སྤྱངི	སྤྱང་ཀི
སྤྱནི༹ཊ	སྤྱན་གཟིགས
སྤྱནིཊ	སྤྱན་གཟིགས
སྤྱིནགས	སྤྱན་གཟིགས
སྤྱནར	སྤྱན་དམར
སྤྱནངསོ	སྤྱན་དྲངས་སོ
སྤྱངྲས	སྤྱན་དྲངས
སྤྱངྲས	སྤྱན་དྲངས
སྤྱནངས	སྤྱན་དྲངས
སྤྱནྔར	སྤྱན་དྲངས
སྤྱནྲངས	སྤྱན་དྲངས
སྤྱནེ	སྤྱན་འདྲེན
སྤྱནྲེ	སྤྱན་འདྲེན
སྤྱནསྱི	སྤྱན་རས་ཀྱིས
སྤྱནསིཊ༹ན	སྤྱན་རས་གཟིགས་ཀྱི་མཚན
སྤྱནསི༹ཊ	སྤྱན་རས་གཟིགས
སྤྱརསིཊ	སྤྱན་རས་གཟིགས
སྤྱརི༹ཊ	སྤྱན་རས་གཟིགས
སྤྱས་གཟིགས	སྤྱན་རས་གཟིགས
སྤྱྲ༹་ཨིགས	སྤྱན་རས་གཟིགས
སྤནྲསིཌ	སྤྱན་རས་གཟིགས
སྤྱནྔར	སྤྱན་སྔར
སྤྱིུག༹	སྤྱི་གཙུག
སྤྱིུག	སྤྱི་གཙུག
སྤྱིནོ	སྤྱི་དོན
སྤྱོིན	སྤྱི་དོན
སྤྱིརོ	སྤྱི་བོར
སྤྱོིར	སྤྱི་བོར
སྤྱིཐུནྱྃ	སྤྱི་མཐུན་གྱི་
སྤྱི༹ན	སྤྱི་མཚན
སྤྱྮིག	སྤྱི་ཞག
སྤྱྮིག	སྤྱི་ཞག
སྤྱིའི་ལེར	སྤྱིའི་ལེ་བར
སྤྱུགོ	སྤྱུག་གོ
སྤྱེནངསོ	སྤྱེན་དྲངས་སོ
སྤྱེནངས	སྤྱེན་དྲངས
སྤྱིངིྃ་	སྤྱོ་མིང་
སྤྱོདའི	སྤྱོད་པའི
སྥྱོདས	སྤྱོད་པས
སྤྱོདླྃ	སྤྱོད་ལམ
སྤྱོལྡན	སྤྱོད་ལྡན
སྤྲའེུ	སྤྲ་སྤྲེའུ
སྤྲངོ༌	སྤྲང་པོ
སྤྲིངགི	སྤྲིང་ཡིག
སྤྲིནྱི་བཅུད	སྤྲིན་གྱི་བཅུད
སྤྲིནེ	སྤྲིན་ཆེན
སྤྱིནེ་	སྤྲིན་ཏེ་
སྤྲིནུས	སྤྲིན་དུས
སྤྲིནྲ	སྤྲིན་བྲལ
སྤྲིསཾ	སྤྲིས་མ
སྤྲུཌ	སྤྲུགས
སྤྲེའུཛིནྱདེ	སྤྲེའུ་འཛིན་པའི
སྤྲེའོུ	སྤྲེའུའོ
སྤྲེལྱི	སྤྲེལ་གྱི
སྤྲཽ	སྤྲོ་སྤྲོ
སྤྲོལ	སྤྲོས་བྲལ
སྤྲོསྲལ	སྤྲོས་བྲལ
སྤྲོསལ	སྤྲོས་བྲལ
སྦལྕོང	སྦལ་ལྕོང
སྦསྐུངས	སྦས་སྐུངས
སྦུབསུ	སྦུབས་སུ
སྦུབསྐྱེས	སྦུབས་སྐྱེས
སྔོནྱི་	སྦོན་གྱི་
སྦོམོ	སྦོམ་པོ
སྦོོཾ	སྦོམ་པོ
སྦྱཾ་	སྦྱང་
སྦྱངྣས	སྦྱངས་ནས
སྦྱངསིང་	སྦྱངས་ཤིང་
སྦྱིནས	སྦྱིན་གནས
སྦྱིནྱི	སྦྱིན་གྱི
སྦྱིནྱིས	སྦྱིན་གྱིས
སྦྱིནོ	སྦྱིན་ནོ
སྦྱིནེ	སྦྱིན་ལེན
སྦྱིནྲེག	སྦྱིན་སྲེག
སྦྱིནྲེག	སྦྱིན་སྲེག
སྦྱོངསྨན	སྦྱོང་སྨན
སྦྱོརཡྱོཕྲུལྶྣཾང	སྦྱོར་གཡོ་འཕྲུལ་སྣ་མང
སྦྱོརྙི	སྦྱོར་ཉི
སྦྱོརཐོྃ	སྦྱོར་མཐོང
སྦྦྱྲོལ	སྦྱོར་སྒྲོལ
སྦྱོརལོྲ	སྦྱོར་སྒྲོལ
སྦྲངཾ	སྦྲང་མ
སྦྲ༹ངི༌	སྦྲང་རྩི
སྦྲིང༹	སྦྲང་རྩི
སྦྲིང༹	སྦྲང་རྩི
སྦྲེཾན	སྦྲམ་ཆེན
སྦྲྃ	སྦྲམ
སྦྲུལྱི་	སྦྲུལ་གྱི་
སྦྲུལོ	སྦྲུལ་ལོ
སྦྲུལོའི	སྦྲུལ་ལོའི
སྦྲེལ	སྦྲེལ
སྨབེབསྱེདུཇུག	སྨ་འབེབས་བྱེད་དུ་འཇུག
སྨདཀྲིས	སྨད་དཀྲིས
སྨནྮུང	སྨན་གཞུང
སྨནོ	སྨན་ནོ
སྨནྟུས	སྨན་བཏུས
སྨརྩྖེན	སྨན་རྩ་ཆེན
སྨྲིལོ	སྨིན་གྲོལ
སྨྲོིལ	སྨིན་གྲོལ
སྨིནྲུག	སྨིན་དྲུག
སྨྲིུག	སྨིན་དྲུག
སྨྲིུགན	སྨིན་དྲུག་ཅན
སྨྲིུག	སྨིན་དྲུག
སྨིནཾ	སྨིན་མ
སྨེུན	སྨེ་བདུན
སྨོནཾ	སྨོན་ལམ
སྐོཾས	སྨོམས
སྨྱུགཁསོཌ	སྨྱུག་ཁ་བསེགས
སྨྱུགཁ	སྨྱུག་ཁ
སྨྱུགཾའིསླསའི	སྨྱུག་མའི་སླས་པའི
སྨྱུགཾས	སྨྱུག་མས
སྨྲའི	སྨྲ་བའི
སྨྲསོ	སྨྲས་སོ
སྩོུལ	སྩལ་དུ་གསོལ
སྲའི	སྲ་བའི
སྲརྟན	སྲ་བརྟན
སྲེཾཊ	སྲ་མཁྲེགས
སྲཁྲེཌ	སྲ་མཁྲེགས
སྲཐསྲ	སྲ་འཐའ་སྲ
སྲཐས	སྲ་འཐས
སྲབྲས	སྲ་འབྲས
སྲརྫིན	སྲ་འཛིན
སྲརྩི	སྲ་རྩི
སྲྶྙི	སྲ་སྙི
སྲངྖ	སྲང་ཆ
སྲངྖའི	སྲང་ཆའི
སྲངཾདའ	སྲང་མདའ
སྲངལྲཾངདོཾ	སྲང་ལམ་སྲང་མདོ
སྲདཀར	སྲད་དཀར
སྲདཾར	སྲད་དམར
སྲདུབཅུག	སྲད་དུ་བཅུག
སྲདྣགང	སྲད་ནག་དང
སྲདུ	སྲད་བུ
སྲདཾ་	སྲད་མ་
སྲདེར	སྲད་སེར
སྲདསྨུག	སྲད་སྨུག
སྲནཀར	སྲན་དཀར
སྲནག	སྲན་ནག
སྲནཾ	སྲན་མ
སྲནརིཌ་	སྲན་རིགས་
སྲབྱིསྒྱར	སྲབ་ཀྱིས་བསྒྱུར
སྲབོ	སྲབ་པོ
སྲབཾཐུག	སྲབ་མཐུག
སྲབཾདའ	སྲབ་མདའ
སྲབོཾ་	སྲབ་མོ་
སྲབོཾར	སྲབ་མོར
སྲབཇཾ	སྲབ་འཇམ
སྲབསྐྱོཌ	སྲབ་སྐྱོགས
སྲམདོག	སྲམ་མདོག
སྲཾལྤཌ	སྲམ་ལྤགས
སྲཾ	སྲམ
སྲསྱི	སྲས་ཀྱི
སྲསྱིས་ནེ	སྲས་ཀྱིས་ན་རེ
སྲསྱིས	སྲས་ཀྱིས
སྲསྖེ	སྲས་ཆེ
སྲསེན	སྲས་ཆེན
སྲསྲོསོཾ	སྲས་པོ་སྲས་མོ་
སྲསྱདྱིས	སྲས་བརྒྱད་ཀྱིས
སྲསྱད	སྲས་བརྒྱད
སྲསུ	སྲས་སུ
སྲིར	སྲི་ཐར
སྲིབྱདེ	སྲི་བྱེད
སྲིཞུ	སྲི་ཞུ
སྲིངོ	སྲིང་མོ
སྲིངོཾ་	སྲིང་མོ་
སྲིདཞུང	སྲིད་གཞུང
སྲིདཇུས	སྲིད་ཇུས
སྲིདང	སྲིད་དང
སྲིདབང	སྲིད་དབང
སྲིདུ	སྲིད་དུ
སྲིདོན	སྲིད་དོན
སྲིདནགྲནྲལ	སྲིད་ན་འགྲན་བྲལ
སྲིདའི་	སྲིད་པའི་
སྲིདར	སྲིད་པར
སྲིདཾཐའཙཾ	སྲིད་མཐའ་ཙམ
སྲིདཾཐའ	སྲིད་མཐའ
སྲིདཞི	སྲིད་ཞི
སྲིདཞེང	སྲིད་ཞེང
སྲིདབྱུང	སྲིད་འབྱུང
སྲིུདང༌	སྲིད་སྲུང༌
སྲིནད	སྲིན་ནད
སྲིནོ	སྲིན་པོ
སྲོིན	སྲིན་པོ
སྲིནོ	སྲིན་པོ
སྲིནོའི་གྲོངེར	སྲིན་པོའི་གྲོང་ཁྱེར
སྲིནོའི	སྲིན་པོའི
སྲིནོའི	སྲིན་པོའི་
སྲིནོར	སྲིན་པོར
སྲིནྦལ	སྲིན་བལ
སྲིནུ	སྲིན་བུ
སྲིནྱ་	སྲིན་བྱ་
སྲིནོཾ	སྲིན་མོ
སྲོིནཾ	སྲིན་མོ
སྲིནླག	སྲིན་ལག
སྲིནྴིང	སྲིན་ཤིང
སྲིབསིགྲུབྶྟེ	སྲིབས་ཤིག་འགྲུབ་སྟེ
སྲིའུསྱོ་	སྲིའུ་གསོ་
སྲིལྟེ	སྲིལ་ཏེ
སྲིསིག	སྲིས་ཤིག
སྲོུཾ་	སྲུ་མོ་
སྲུངའིོརོ	སྲུང་བའི་འཁོར་ལོ
སྲུངརཾཛོདགི	སྲུང་བར་མཛོད་ཅིག
སྲུངར	སྲུང་བར
སྲུངཾ	སྲུང་མ
སྲུངཾཁན	སྲུང་མཁན
སྲུངཾཛད	སྲུང་མཛད
སྲུངཾར	སྲུང་མར
སྲུངའོར	སྲུང་འཁོར
སྲུངཾས	སྲུངས་མ
སྲུངསཾ	སྲུངས་མ
སྲུངསིགྲུངསིག	སྲུངས་ཤིག་སྲུངས་ཤིག
སྲུནྱིན	སྲུན་གྱིན
སྲུནིག	སྲུན་ཅིག
སྲུནོཾ	སྲུན་མོ
སྲུབྐརྃཚྃས	སྲུབ་ཀ་བར་མཚམས
སྲུགྱིནྲུབ	སྲུབ་ཀྱིན་སྲུབ
སྲུབསྐ	སྲུབས་ཀ
སྲུབསཾ	སྲུབས་མ
སྲུབསྯིནྕན	སྲུབས་ཟིན་ཅན
སྲུབསྯིན	སྲུབས་ཟིན
སྲུསྣིབྲུ	སྲུས་ནི་འབྲུ
སྲེཐིག	སྲེ་ཐིག
སྲྣེག	སྲེ་ནག
སྲེོ་	སྲེ་བོ་
སྲེོཾ	སྲེ་མོ་
སྲེོཾགྯེར	སྲེ་མོག་ཟེར
སྲེོངཾ	སྲེ་མོང
སྲླེོང	སྲེ་ལོང
སྲེགཁང	སྲེག་ཁང
སྲེགནསྲེད	སྲེག་གནས་སྲེད
སྲེགནས	སྲེག་གནས
སྲེགིནདུག	སྲེག་གིན་འདུག
སྲེག་ཾ	སྲེག་མ་
སྲ􀴖༹སུ	སྲེག་ཚེས་སུ
སྲཻས	སྲེག་ཚེས
སྲེེ༹ས	སྲེག་ཚེས
སྲོེས	སྲེག་ཚེས
སྲེགཤ	སྲེག་ཤ
སྲེགྱོར	སྲེག་སྦྱོར
སྲོེར	སྲེག་སྦྱོར
སྲཻག	སྲེག་སྲེག
སྲེཌིག	སྲེགས་ཤིག
སྲེཌ	སྲེགས
སྲེལགོས	སྲེལ་དགོས
སྲེསིག	སྲེས་ཤིག
སྲོཁང	སྲོ་ཁང
སྲོཞིན	སྲོ་བཞིན
སྲོ་	སྲོ་མ
སྲོཾངང	སྲོ་མང་ཡང
སྲློོཀརཔ་	སྲོ་ལོ་དཀར་བོ་
སྲློོམརོ	སྲོ་ལོ་དམར་བོ
སྲཽགད	སྲོག་གཅོད
སྲོགོད	སྲོག་གཅོད
སྲོགྕོད	སྲོག་གཅོད
སྲོགནསའིསྱོནོའོ་	སྲོག་གནས་པའི་གསོན་པོའོ་
སྲོགནས	སྲོག་གནས
སྲོགསུཾ	སྲོག་གསུམ
སྲོགན	སྲོག་ཅན
སྲྖོགསྲོགཏང	སྲོག་ཆགས་སྲོག་བཏང
སྲོགྦང	སྲོག་དབང
སྲོགྕད	སྲོག་བཅད
སྲོགཾདེ	སྲོག་མེད
སྲོགྲླུང	སྲོག་རླུང
སྲོགིང	སྲོག་ཤིང
སོངཙན་	སྲོང་བཙན
སྲོངོའཾ་	སྲོང་བོའམ་
སྲོངརོཤདང	སྲོང་བོར་བཤད་དང
སྲོངསིག	སྲོངས་ཤིག
སྲོདང	སྲོད་དང
རྲོངསྲོདུསྣི	སྲོད་དུས་ནི་
སྲོདུས	སྲོད་དུས
སྲོནང	སྲོན་དང
སྲོནཾཁན	སྲོན་མཁན
སྲོབསིག	སྲོབས་ཤིག
སྲོལྒོང	སྲོལ་གོང
སྲོལྔནསྣུབསིག	སྲོལ་ངན་སྣུབས་ཤིག
སྲོལྱེསྱར་ཾ	སྲོལ་ཕྱེས་གསར་མ་
སྲོལཏོདེ	སྲོལ་བཏོད་དེ
སྲོལུ༹ཊ	སྲོལ་ཚུགས
སྲོལྱེདཾཁན	སྲོལ་འབྱེད་མཁན
སྲོལྱེད	སྲོལ་འབྱེད
སྲོལཾ	སྲོལ་ལམ
སྲོསུས	སྲོས་དུས
སྲོསླ་	སྲོས་ཟླ་
སརྡོཁུརྱེད་ོ	སླ་རྡོ་འཁུར་བྱེད་དོ་
སླངཁརླ	སླང་འཁར་སླང
སླདུ	སླད་དུ
སླདྣསླདཾར	སླད་ནས་སླད་མར
སླནྖདྱང	སླན་ཆད་ཀྱང
སླནད	སླན་ཆད
སླརྗོད	སླར་བརྗོད
སླརསྡུ	སླར་བསྡུ
སླརབྱུང	སླར་འབྱུང
སླརང	སླར་ཡང
སླརློག	སླར་ལོག
སླརློག	སླར་སློག
པསླས་ཾ	སླས་མ
སླུབྲིད	སླུ་བྲིད
སླུཾཁནསླུཉེནྖེ	སླུ་མཁན་སླུ་ཉེན་ཆེ
སླུཚིགིསླུསིག	སླུ་ཚིག་གིས་སླུས་ཤིག
སླེུཾས	སླུ་སེམས
སླེཏྲེསཁྲིལྣསྐྱེའི	སླེ་ཏྲེས་འཁྲིལ་ནས་སྐྱེ་བའི
སླེ༤ན	སླེ་བཞིན
སླེ་ོ	སླེ་བོ་
སློསྣོདེ	སླེ་བོ་སྣོདདེ
སླེཞེསྦལྱིདནཾ	སླེ་ཞེས་བལ་གྱི་གདན་ནམ
སླེབྱིན	སླེབ་ཀྱིན
སླེབཁར	སླེབ་ཁར
སླེབསིགང	སླེབས་ཤིག་དང
སླེསིག	སླེས་ཤིག
སླཽས	སློ་གྲོས
སློ་ཾ	སློ་མ་
སློབོ་	སློ་འབོ་
སློགཾབྱེད	སློག་མ་བྱེད
སློགྶྟེ	སློག་སྟེ
སློཌིགསྐུལློངོངཾཁན	སློགས་ཤིག་སྐུལ་སློང་སློང་མཁན
སློངོཾ	སློང་མོ
སློངསིགློད	སློངས་ཤིག་སློད
སློབྙེར	སློབ་གཉེར
སློེབྙར	སློབ་གཉེར
སློབཉྱེར	སློབ་གཉེར
སློབྲྭ	སློབ་གྲྭ
སློབསྱར	སློབ་གསར
སློབསྱོི་	སློབ་གསོའི་
སློབྲྭ	སློབ་གྲྭ
སློབྠུནཾངོར	སློབ་ཐུན་མང་བོར
དཔོན་སློབ	སློབ་དཔོན་དང་སློབ་མ
སླཽན	སློབ་དཔོན
སློན	སློབ་དཔོན
སླཽབན	སློབ་དཔོན
སློབོན	སློབ་དཔོན
སློོན	སློབ་དཔོན
སློབྤ	སློབ་པ
སློབྲུག	སློབ་ཕྲུག
སློབུ	སློབ་བུ
སློབཾ	སློབ་མ
སློབཾའི་	སློབ་མའི་
སླཽད	སློབ་འདོད
སློབོད	སློབ་འདོད
སློོད	སློབ་འདོད
སློབྱུད	སློབ་རྒྱུད
སློབྶེང	སློབ་སེང
སློབྶྦྱོང	སློབ་སྦྱོང
ཧྕང	ཧ་ཅང
ཧཱ	ཧ་ཧ
ཧནོ	ཧན་ཧོན
ཧབོ	ཧབ་ཧོབ
ཧལྱི	ཧལ་ཁྱི
ཧེུ་ཀ	ཧེ་རུ་ཀ
ཧྲངང༌	ཧྲང་ཧྲང༌
ཧྲིལོ	ཧྲིལ་པོ
ཧྲིལཛིན	ཧྲིལ་འཛིན
ཨྖེ་	ཨ་ཆེ་
ཨགྣེ	ཨག་ནེ
ཨབཏབ་པ	ཨབ་བཏབ་པ
ཨརས	ཨར་ལས
ཨིནྲ	ཨིནྡྲ
ཡིནཾ	ཨིན་ནམ
ཨུགོས	ཨུག་ཆོས
ཨེཾཪ༹	ཨེ་མ་མཚར
ཨེཾ་ཧོ	ཨེ་མ་ཧོ
ཨཻ	ཨེ་ཨེ
ཨེིཾ	ཨེམ་ཆི
ཨྱོན་ཐྲོེང༹ལ	ཨོ་རྒྱན་ཐོད་ཕྲེང་རྩལ
ཨྱོན་པདྨ	ཨོ་རྒྱན་པད་མ
ཨྱོན	ཨོ་རྒྱན
ཨཽ	ཨོ་ཨོ
ཨོམུ༹ཊོ	ཨོམ་ཚུགས་སོ།
ཨྱུན	ཨཽ་རྒྱན
